"Provincia","Canton"," Parroquia","Hombre","Mujer","Total"
"Azuay","CAMILO PONCE ENRIQUEZ         "," CAMILO PONCE ENRIQUEZ","9766","7638","17404"
"Azuay",""," EL CARMEN DE PIJILI","2445","2149","4594"
"Azuay",""," Total","12211","9787","21998"
"Azuay","CHORDELEG                     "," CHORDELEG","3241","3546","6787"
"Azuay",""," LA UNION","867","1029","1896"
"Azuay",""," LUIS GALARZA ORELLANA","661","833","1494"
"Azuay",""," PRINCIPAL","597","734","1331"
"Azuay",""," SAN MARTIN DE PUZHIO","455","614","1069"
"Azuay",""," Total","5821","6756","12577"
"Azuay","CUENCA                        "," BAÑOS","7868","8983","16851"
"Azuay",""," CHAUCHA","617","680","1297"
"Azuay",""," CHECA (JIDCAY)","1182","1559","2741"
"Azuay",""," CHIQUINTAD","2251","2575","4826"
"Azuay",""," CUENCA","158365","173523","331888"
"Azuay",""," CUMBE","2480","3066","5546"
"Azuay",""," LLACAO","2487","2855","5342"
"Azuay",""," MOLLETURO","3681","3485","7166"
"Azuay",""," NULTI","2107","2217","4324"
"Azuay",""," OCTAVIO CORDERO PALACIOS","983","1288","2271"
"Azuay",""," PACCHA","2961","3506","6467"
"Azuay",""," QUINGEO","3421","4029","7450"
"Azuay",""," RICAURTE","9247","10114","19361"
"Azuay",""," SAN JOAQUIN","3522","3933","7455"
"Azuay",""," SANTA ANA","2472","2894","5366"
"Azuay",""," SAYAUSI","3943","4449","8392"
"Azuay",""," SIDCAY","1743","2221","3964"
"Azuay",""," SININCAY","7277","8582","15859"
"Azuay",""," TARQUI","4833","5657","10490"
"Azuay",""," TURI","4177","4787","8964"
"Azuay",""," VALLE","11489","12825","24314"
"Azuay",""," VICTORIA DEL PORTETE","2391","2860","5251"
"Azuay",""," Total","239497","266088","505585"
"Azuay","EL PAN                        "," EL PAN","569","627","1196"
"Azuay",""," SAN VICENTE","851","989","1840"
"Azuay",""," Total","1420","1616","3036"
"Azuay","GIRON                         "," ASUNCION","1429","1622","3051"
"Azuay",""," GIRON","3834","4603","8437"
"Azuay",""," SAN GERARDO","514","605","1119"
"Azuay",""," Total","5777","6830","12607"
"Azuay","GUACHAPALA                    "," GUACHAPALA","1560","1849","3409"
"Azuay",""," Total","1560","1849","3409"
"Azuay","GUALACEO                      "," DANIEL CORDOVA TORAL","722","980","1702"
"Azuay",""," GUALACEO","9973","11470","21443"
"Azuay",""," JADAN","2042","2284","4326"
"Azuay",""," LUIS CORDERO VEGA","902","1128","2030"
"Azuay",""," MARIANO MORENO","1181","1435","2616"
"Azuay",""," REMIGIO CRESPO TORAL","616","798","1414"
"Azuay",""," SAN JUAN","2314","2991","5305"
"Azuay",""," SIMON BOLIVAR","515","613","1128"
"Azuay",""," ZHIDMAD","1216","1529","2745"
"Azuay",""," Total","19481","23228","42709"
"Azuay","NABON                         "," COCHAPATA","1410","1662","3072"
"Azuay",""," EL PROGRESO","966","1046","2012"
"Azuay",""," LAS NIEVES (CHAYA)","605","677","1282"
"Azuay",""," NABON","4359","5167","9526"
"Azuay",""," Total","7340","8552","15892"
"Azuay","OÑA                           "," OÑA","1091","1304","2395"
"Azuay",""," SUSUDEL","556","632","1188"
"Azuay",""," Total","1647","1936","3583"
"Azuay","PAUTE                         "," BULAN","994","1179","2173"
"Azuay",""," CHICAN","1694","1950","3644"
"Azuay",""," DUG-DUG","860","1043","1903"
"Azuay",""," EL CABO","1553","1767","3320"
"Azuay",""," GUARAINAG","390","456","846"
"Azuay",""," PAUTE","4635","5215","9850"
"Azuay",""," SAN CRISTOBAL","1122","1290","2412"
"Azuay",""," TOMEBAMBA","633","713","1346"
"Azuay",""," Total","11881","13613","25494"
"Azuay","PUCARA                        "," PUCARA","3985","4230","8215"
"Azuay",""," SAN RAFAEL DE SHARUG","913","924","1837"
"Azuay",""," Total","4898","5154","10052"
"Azuay","SAN FERNANDO                  "," CHUMBLIN","327","422","749"
"Azuay",""," SAN FERNANDO","1417","1827","3244"
"Azuay",""," Total","1744","2249","3993"
"Azuay","SANTA ISABEL                  "," ABDON CALDERON","2291","2340","4631"
"Azuay",""," SANTA ISABEL","5603","6004","11607"
"Azuay",""," ZHAGLLI","1016","1139","2155"
"Azuay",""," Total","8910","9483","18393"
"Azuay","SEVILLA DE ORO                "," AMALUZA","833","590","1423"
"Azuay",""," PALMAS","1075","1146","2221"
"Azuay",""," SEVILLA DE ORO","1034","1211","2245"
"Azuay",""," Total","2942","2947","5889"
"Azuay","SIGSIG                        "," CUCHIL","725","963","1688"
"Azuay",""," GIMA","1299","1587","2886"
"Azuay",""," GUEL","564","784","1348"
"Azuay",""," LUDO","1494","1872","3366"
"Azuay",""," SAN BARTOLOME","1834","2267","4101"
"Azuay",""," SAN JOSE DE RARANGA","1040","1311","2351"
"Azuay",""," SIGSIG","4959","6211","11170"
"Azuay",""," Total","11915","14995","26910"
"Azuay","Total","","337044","375083","712127"
"Bolivar","CALUMA                        "," CALUMA","6509","6620","13129"
"Bolivar",""," Total","6509","6620","13129"
"Bolivar","CHILLANES                     "," CHILLANES","6659","6615","13274"
"Bolivar",""," SAN JOSE DEL TAMBO","2192","1940","4132"
"Bolivar",""," Total","8851","8555","17406"
"Bolivar","ECHEANDIA                     "," ECHEANDIA","6149","5965","12114"
"Bolivar",""," Total","6149","5965","12114"
"Bolivar","GUARANDA                      "," FACUNDO VELA","1712","1607","3319"
"Bolivar",""," GUARANDA","26155","29219","55374"
"Bolivar",""," JULIO E. MORENO","1443","1505","2948"
"Bolivar",""," SALINAS","2944","2877","5821"
"Bolivar",""," SAN LORENZO","929","928","1857"
"Bolivar",""," SAN LUIS DE PAMBIL","2779","2578","5357"
"Bolivar",""," SAN SIMON (YACOTO)","2048","2155","4203"
"Bolivar",""," SANTAFE (SANTA FE)","822","930","1752"
"Bolivar",""," SIMIATUG","5521","5725","11246"
"Bolivar",""," Total","44353","47524","91877"
"Bolivar","LAS NAVES                     "," LAS NAVES","3135","2957","6092"
"Bolivar",""," Total","3135","2957","6092"
"Bolivar","SAN JOSE DE CHIMBO            "," ASUNCION (ASANCOTO)","1366","1471","2837"
"Bolivar",""," MAGDALENA (CHAPACOTO)","1349","1470","2819"
"Bolivar",""," SAN JOSE DE CHIMBO","2734","3075","5809"
"Bolivar",""," SAN SEBASTIAN","535","522","1057"
"Bolivar",""," TELIMBELA","1669","1588","3257"
"Bolivar",""," Total","7653","8126","15779"
"Bolivar","SAN MIGUEL                    "," BALSAPAMBA","1415","1350","2765"
"Bolivar",""," BILOVAN","1375","1370","2745"
"Bolivar",""," REGULO DE MORA","468","476","944"
"Bolivar",""," SAN MIGUEL","5880","6529","12409"
"Bolivar",""," SAN PABLO","2640","2849","5489"
"Bolivar",""," SAN VICENTE","572","571","1143"
"Bolivar",""," SANTIAGO","875","874","1749"
"Bolivar",""," Total","13225","14019","27244"
"Bolivar"," Total","","89875","93766","183641"
"Cañar","AZOGUES                       "," AZOGUES","17667","20328","37995"
"Cañar",""," COJITAMBO","1594","2095","3689"
"Cañar",""," GUAPAN","3933","4920","8853"
"Cañar",""," JAVIER LOYOLA","3142","3665","6807"
"Cañar",""," LUIS CORDERO","1690","2181","3871"
"Cañar",""," PINDILIG","973","1130","2103"
"Cañar",""," RIVERA","722","820","1542"
"Cañar",""," SAN MIGUEL","1613","1954","3567"
"Cañar",""," TADAY","754","883","1637"
"Cañar",""," Total","32088","37976","70064"
"Cañar","BIBLIAN                       "," BIBLIAN","6106","7599","13705"
"Cañar",""," JERUSALEN","761","984","1745"
"Cañar",""," NAZON","1106","1459","2565"
"Cañar",""," SAN FRANCISCO DE SAGEO","765","966","1731"
"Cañar",""," TURUPAMBA","455","616","1071"
"Cañar",""," Total","9193","11624","20817"
"Cañar","CAÑAR                         "," CAÑAR","8509","9826","18335"
"Cañar",""," CHONTAMARCA","1916","2224","4140"
"Cañar",""," CHOROCOPTE","1397","1691","3088"
"Cañar",""," DUCUR","2077","2076","4153"
"Cañar",""," GENERAL MORALES","1609","1791","3400"
"Cañar",""," GUALLETURO","1756","2086","3842"
"Cañar",""," HONORATO VASQUEZ","2697","3529","6226"
"Cañar",""," INGAPIRCA","3683","4657","8340"
"Cañar",""," JUNCAL","976","1193","2169"
"Cañar",""," SAN ANTONIO","1024","950","1974"
"Cañar",""," VENTURA","632","656","1288"
"Cañar",""," ZHUD","1094","1274","2368"
"Cañar",""," Total","27370","31953","59323"
"Cañar","DELEG                         "," DELEG","1878","2555","4433"
"Cañar",""," SOLANO","751","916","1667"
"Cañar",""," Total","2629","3471","6100"
"Cañar","EL TAMBO                      "," EL TAMBO","4364","5111","9475"
"Cañar",""," Total","4364","5111","9475"
"Cañar","LA TRONCAL                    "," LA TRONCAL","21176","21434","42610"
"Cañar",""," MANUEL J. CALLE","1442","1323","2765"
"Cañar",""," PANCHO NEGRO","4702","4312","9014"
"Cañar",""," Total","27320","27069","54389"
"Cañar","SUSCAL                        "," SUSCAL","2271","2745","5016"
"Cañar",""," Total","2271","2745","5016"
"Cañar"," Total","","105235","119949","225184"
"Carchi","BOLIVAR                       "," BOLIVAR","2623","2583","5206"
"Carchi",""," GARCIA MORENO","695","711","1406"
"Carchi",""," LOS ANDES","1082","1178","2260"
"Carchi",""," MONTE OLIVO","889","801","1690"
"Carchi",""," SAN RAFAEL","873","868","1741"
"Carchi",""," SAN VICENTE DE PUSIR","1004","1040","2044"
"Carchi",""," Total","7166","7181","14347"
"Carchi","ESPEJO                        "," EL ANGEL","3044","3281","6325"
"Carchi",""," EL GOALTAL","436","380","816"
"Carchi",""," LA LIBERTAD (ALIZO)","1741","1761","3502"
"Carchi",""," SAN ISIDRO","1306","1415","2721"
"Carchi",""," Total","6527","6837","13364"
"Carchi","","","Hombre","Mujer","Total"
"Carchi","MIRA                          "," CONCEPCION","1414","1393","2807"
"Carchi",""," JIJON Y CAAMAÑO","1101","970","2071"
"Carchi",""," JUAN MONTALVO","671","637","1308"
"Carchi",""," MIRA (CHONTAHUASI)","2935","3059","5994"
"Carchi",""," Total","6121","6059","12180"
"Carchi","MONTUFAR                      "," CHITAN DE NAVARRETE","313","305","618"
"Carchi",""," CRISTOBAL COLON","1449","1494","2943"
"Carchi",""," FERNANDEZ SALVADOR","663","619","1282"
"Carchi",""," LA PAZ","1665","1767","3432"
"Carchi",""," PIARTAL","586","554","1140"
"Carchi",""," SAN GABRIEL","10234","10862","21096"
"Carchi",""," Total","14910","15601","30511"
"Carchi","SAN PEDRO DE HUACA            "," HUACA","3163","3078","6241"
"Carchi",""," MARISCAL SUCRE","684","699","1383"
"Carchi",""," Total","3847","3777","7624"
"Carchi","TULCAN                        "," EL CARMELO (EL PUN)","1405","1384","2789"
"Carchi",""," EL CHICAL","1756","1681","3437"
"Carchi",""," JULIO ANDRADE (OREJUELA)","4876","4758","9634"
"Carchi",""," MALDONADO","893","810","1703"
"Carchi",""," PIOTER","367","351","718"
"Carchi",""," SANTA MARTHA DE CUBA","1196","1170","2366"
"Carchi",""," TOBAR DONOSO (LA BOCANA)","473","432","905"
"Carchi",""," TUFIÑO","1171","1168","2339"
"Carchi",""," TULCAN","29312","31091","60403"
"Carchi",""," URBINA (TAYA)","1135","1069","2204"
"Carchi",""," Total","42584","43914","86498"
"Carchi","Total","","81155","83369","164524"
"Cotopaxi","LA MANA                       "," GUASAGANDA","1997","1911","3908"
"Cotopaxi",""," LA MANA","18359","17895","36254"
"Cotopaxi",""," PUCAYACU","1064","990","2054"
"Cotopaxi",""," Total","21420","20796","42216"
"Cotopaxi","LATACUNGA                     "," 11 DE NOVIEMBRE (ILINCHI","944","1044","1988"
"Cotopaxi",""," ALAQUES (ALAQUEZ)","2625","2856","5481"
"Cotopaxi",""," BELISARIO QUEVEDO","2991","3368","6359"
"Cotopaxi",""," GUAITACAMA (GUAYTACAMA)","5128","4540","9668"
"Cotopaxi",""," JOSEGUANGO BAJO","1380","1489","2869"
"Cotopaxi",""," LATACUNGA","47143","51212","98355"
"Cotopaxi",""," MULALO","3870","4225","8095"
"Cotopaxi",""," POALO","2732","2977","5709"
"Cotopaxi",""," SAN JUAN DE PASTOCALLE","5494","5955","11449"
"Cotopaxi",""," TANICUCHI","6256","6575","12831"
"Cotopaxi",""," TOACASO","3738","3947","7685"
"Cotopaxi",""," Total","82301","88188","170489"
"Cotopaxi","PANGUA                        "," EL CORAZON","3267","3298","6565"
"Cotopaxi",""," MORASPUNGO","6553","5823","12376"
"Cotopaxi",""," PINLLOPATA","530","500","1030"
"Cotopaxi",""," RAMON CAMPAÑA","990","1004","1994"
"Cotopaxi",""," Total","11340","10625","21965"
"Cotopaxi","PUJILI                        "," ANGAMARCA","2480","2769","5249"
"Cotopaxi",""," GUANGAJE","3809","4217","8026"
"Cotopaxi",""," LA VICTORIA","1438","1578","3016"
"Cotopaxi",""," PILALO","1272","1368","2640"
"Cotopaxi",""," PUJILI","15732","17698","33430"
"Cotopaxi",""," TINGO","2081","1970","4051"
"Cotopaxi",""," ZUMBAHUA","5924","6719","12643"
"Cotopaxi",""," Total","32736","36319","69055"
"Cotopaxi","SALCEDO                       "," ANTONIO JOSE HOLGUIN","1256","1408","2664"
"Cotopaxi",""," CUSUBAMBA","3490","3710","7200"
"Cotopaxi",""," MULALILLO","2982","3397","6379"
"Cotopaxi",""," MULLIQUINDIL (SANTA ANA)","3516","3687","7203"
"Cotopaxi",""," PANSALEO","1586","1869","3455"
"Cotopaxi",""," SAN MIGUEL","15050","16265","31315"
"Cotopaxi",""," Total","27880","30336","58216"
"Cotopaxi","SAQUISILI                     "," CANCHAGUA","2614","2841","5455"
"Cotopaxi",""," CHANTILIN","453","582","1035"
"Cotopaxi",""," COCHAPAMBA","2557","2869","5426"
"Cotopaxi",""," SAQUISILI","6333","7071","13404"
"Cotopaxi",""," Total","11957","13363","25320"
"Cotopaxi","SIGCHOS                       "," CHUGCHILAN","3797","4014","7811"
"Cotopaxi",""," ISINLIVI","1625","1602","3227"
"Cotopaxi",""," LAS PAMPAS","1024","919","1943"
"Cotopaxi",""," PALO QUEMADO","567","463","1030"
"Cotopaxi",""," SIGCHOS","3978","3955","7933"
"Cotopaxi",""," Total","10991","10953","21944"
"Cotopaxi","Total","","198625","210580","409205"
"Chimborazo","ALAUSI                        "," ACHUPALLAS","5004","5525","10529"
"Chimborazo",""," ALAUSI","4935","5275","10210"
"Chimborazo",""," GUASUNTOS","1101","1312","2413"
"Chimborazo",""," HUIGRA","1147","1205","2352"
"Chimborazo",""," MULTITUD","1058","1026","2084"
"Chimborazo",""," PISTISHI (NARIZ DEL DIABLO)","165","180","345"
"Chimborazo",""," PUMALLACTA (PUMAL-LACTA)","412","493","905"
"Chimborazo",""," SEVILLA","370","433","803"
"Chimborazo",""," SIBAMBE","1898","1971","3869"
"Chimborazo",""," TIXAN","5098","5481","10579"
"Chimborazo",""," Total","21188","22901","44089"
"Chimborazo","CHAMBO                        "," CHAMBO","5660","6225","11885"
"Chimborazo",""," Total","5660","6225","11885"
"Chimborazo","CHUNCHI                       "," CAPZOL","426","473","899"
"Chimborazo",""," CHUNCHI","3556","3849","7405"
"Chimborazo",""," COMPUD","423","455","878"
"Chimborazo",""," GONZOL","824","905","1729"
"Chimborazo",""," LLAGOS","833","942","1775"
"Chimborazo",""," Total","6062","6624","12686"
"Chimborazo","COLTA                         "," CAÑI","486","476","962"
"Chimborazo",""," COLUMBE","7776","8086","15862"
"Chimborazo",""," JUAN DE VELASCO (PANGOR)","1926","1992","3918"
"Chimborazo",""," SANTIAGO DE QUITO","2577","3091","5668"
"Chimborazo",""," VILLA LA UNION","8877","9684","18561"
"Chimborazo",""," Total","21642","23329","44971"
"Chimborazo","CUMANDA                       "," CUMANDA","6343","6579","12922"
"Chimborazo",""," Total","6343","6579","12922"
"Chimborazo","GUAMOTE                       "," CEBADAS","4019","4199","8218"
"Chimborazo",""," GUAMOTE","12098","12540","24638"
"Chimborazo",""," PALMIRA","6062","6235","12297"
"Chimborazo",""," Total","22179","22974","45153"
"Chimborazo","GUANO                         "," GUANANDO","183","158","341"
"Chimborazo",""," GUANO","7823","8694","16517"
"Chimborazo",""," ILAPO","810","852","1662"
"Chimborazo",""," LA PROVIDENCIA","267","286","553"
"Chimborazo",""," SAN ANDRES","6477","7004","13481"
"Chimborazo",""," SAN GERARDO DE PACAICAGUAN","1106","1333","2439"
"Chimborazo",""," SAN ISIDRO DE PATULU","2301","2443","4744"
"Chimborazo",""," SAN JOSE DEL CHAZO","495","542","1037"
"Chimborazo",""," SANTA FE DE GALAN","822","851","1673"
"Chimborazo",""," VALPARAISO","211","193","404"
"Chimborazo",""," Total","20495","22356","42851"
"Chimborazo","PALLATANGA                    "," PALLATANGA","5718","5826","11544"
"Chimborazo",""," Total","5718","5826","11544"
"Chimborazo","PENIPE                        "," BILBAO","102","94","196"
"Chimborazo",""," EL ALTAR","631","634","1265"
"Chimborazo",""," LA CANDELARIA","239","236","475"
"Chimborazo",""," MATUS","471","520","991"
"Chimborazo",""," PENIPE","1000","1089","2089"
"Chimborazo",""," PUELA","314","308","622"
"Chimborazo",""," SAN ANTONIO DE BAYUSHIG","517","584","1101"
"Chimborazo",""," Total","3274","3465","6739"
"Chimborazo","RIOBAMBA                      "," CACHA","1410","1750","3160"
"Chimborazo",""," CALPI","3012","3457","6469"
"Chimborazo",""," CUBIJIES","1148","1366","2514"
"Chimborazo",""," FLORES","2074","2472","4546"
"Chimborazo",""," LICAN","3853","4110","7963"
"Chimborazo",""," LICTO","3498","4309","7807"
"Chimborazo",""," PUNGALA","2837","3117","5954"
"Chimborazo",""," PUNIN","2710","3266","5976"
"Chimborazo",""," QUIMIAG","2518","2739","5257"
"Chimborazo",""," RIOBAMBA","74634","82089","156723"
"Chimborazo",""," SAN JUAN","3442","3928","7370"
"Chimborazo",""," SAN LUIS","5704","6298","12002"
"Chimborazo",""," Total","106840","118901","225741"
"Chimborazo","Total","","219401","239180","458581"
"El Oro","ARENILLAS                     "," ARENILLAS","11057","10269","21326"
"El Oro",""," CARCABON","391","345","736"
"El Oro",""," CHACRAS","818","720","1538"
"El Oro",""," PALMALES","1682","1562","3244"
"El Oro",""," Total","13948","12896","26844"
"El Oro","ATAHUALPA                     "," AYAPAMBA","721","666","1387"
"El Oro",""," CERRO AZUL","172","123","295"
"El Oro",""," CORDONCILLO","511","492","1003"
"El Oro",""," MILAGRO","248","224","472"
"El Oro",""," PACCHA","1157","1154","2311"
"El Oro",""," SAN JOSE","201","164","365"
"El Oro",""," Total","3010","2823","5833"
"El Oro","BALSAS                        "," BALSAS","2926","2704","5630"
"El Oro",""," BELLAMARIA","632","599","1231"
"El Oro",""," Total","3558","3303","6861"
"El Oro","CHILLA                        "," CHILLA","1274","1210","2484"
"El Oro",""," Total","1274","1210","2484"
"El Oro","EL GUABO                      "," BARBONES (SUCRE)","3054","2653","5707"
"El Oro",""," EL GUABO","15580","14400","29980"
"El Oro",""," LA IBERIA","1883","1826","3709"
"El Oro",""," RIO BONITO","2953","2523","5476"
"El Oro",""," TENDALES","2916","2221","5137"
"El Oro",""," Total","26386","23623","50009"
"El Oro","HUAQUILLAS                    "," HUAQUILLAS","24120","24165","48285"
"El Oro",""," Total","24120","24165","48285"
"El Oro","LAS LAJAS                     "," EL PARAISO","399","362","761"
"El Oro",""," LA LIBERTAD","421","381","802"
"El Oro",""," LA VICTORIA","1360","1272","2632"
"El Oro",""," SAN ISIDRO","309","290","599"
"El Oro",""," Total","2489","2305","4794"
"El Oro","MACHALA                       "," EL RETIRO","2381","1985","4366"
"El Oro",""," MACHALA","120643","120963","241606"
"El Oro",""," Total","123024","122948","245972"
"El Oro","MARCABELI                     "," EL INGENIO","145","107","252"
"El Oro",""," MARCABELI","2636","2562","5198"
"El Oro",""," Total","2781","2669","5450"
"El Oro","PASAJE                        "," BUENAVISTA","3447","3094","6541"
"El Oro",""," CAÑA QUEMADA","972","867","1839"
"El Oro",""," CASACAY","1260","1197","2457"
"El Oro",""," LA PEAÑA","1825","1776","3601"
"El Oro",""," PASAJE","26743","26742","53485"
"El Oro",""," PROGRESO","2079","1888","3967"
"El Oro",""," UZHCURRUMI","466","450","916"
"El Oro",""," Total","36792","36014","72806"
"El Oro","PIÑAS                         "," CAPIRO","980","890","1870"
"El Oro",""," LA BOCANA","728","637","1365"
"El Oro",""," MOROMORO","742","629","1371"
"El Oro",""," PIEDRAS","294","275","569"
"El Oro",""," PIÑAS","8572","8829","17401"
"El Oro",""," SAN ROQUE","463","404","867"
"El Oro",""," SARACAY","1366","1179","2545"
"El Oro",""," Total","13145","12843","25988"
"El Oro","PORTOVELO                     "," CURTINCAPA","277","233","510"
"El Oro",""," MORALES","337","330","667"
"El Oro",""," PORTOVELO","5176","4820","9996"
"El Oro",""," SALATI","535","492","1027"
"El Oro",""," Total","6325","5875","12200"
"El Oro","SANTA ROSA                    "," BELLAMARIA","1281","1041","2322"
"El Oro",""," BELLAVISTA","1421","1414","2835"
"El Oro",""," JAMBELI","1084","634","1718"
"El Oro",""," LA AVANZADA","1126","942","2068"
"El Oro",""," SAN ANTONIO","1089","1001","2090"
"El Oro",""," SANTA ROSA","26455","26408","52863"
"El Oro",""," TORATA","1038","915","1953"
"El Oro",""," VICTORIA","1733","1454","3187"
"El Oro",""," Total","35227","33809","69036"
"El Oro","ZARUMA                        "," ABAÑIN","842","842","1684"
"El Oro",""," ARCAPAMBA","534","461","995"
"El Oro",""," GUANAZAN","1478","1567","3045"
"El Oro",""," GUIZHAGUIÑA","890","814","1704"
"El Oro",""," HUERTAS","1058","938","1996"
"El Oro",""," MALVAS","640","545","1185"
"El Oro",""," MULUNCAY GRANDE","509","336","845"
"El Oro",""," SALVIAS","394","354","748"
"El Oro",""," SINSAO","685","651","1336"
"El Oro",""," ZARUMA","5253","5306","10559"
"El Oro",""," Total","12283","11814","24097"
"El Oro","Total","","304362","296297","600659"
"Esmeraldas","ATACAMES                      "," ATACAMES","8525","8330","16855"
"Esmeraldas",""," LA UNION","1304","1236","2540"
"Esmeraldas",""," SUA","1781","1668","3449"
"Esmeraldas",""," TONCHIGUE","4151","3850","8001"
"Esmeraldas",""," TONSUPA","5470","5211","10681"
"Esmeraldas",""," Total","21231","20295","41526"
"Esmeraldas","ELOY ALFARO                   "," ANCHAYACU","1432","1105","2537"
"Esmeraldas",""," ATAHUALPA","733","721","1454"
"Esmeraldas",""," BORBON","3931","3765","7696"
"Esmeraldas",""," COLON ELOY DEL MARIA","736","674","1410"
"Esmeraldas",""," LA TOLA","2268","2098","4366"
"Esmeraldas",""," LUIS VARGAS TORRES","199","153","352"
"Esmeraldas",""," MALDONADO","948","913","1861"
"Esmeraldas",""," PAMPANAL DE BOLIVAR","597","521","1118"
"Esmeraldas",""," SAN FRANCISCO DE ONZOLE","768","662","1430"
"Esmeraldas",""," SAN JOSE DE CAYAPAS","785","728","1513"
"Esmeraldas",""," SANTO DOMINGO DE ONZOLE","1055","879","1934"
"Esmeraldas",""," SELVA ALEGRE","597","569","1166"
"Esmeraldas",""," TELEMBI","2944","2695","5639"
"Esmeraldas",""," TIMBIRE","552","485","1037"
"Esmeraldas",""," VALDEZ (LIMONES)","3503","2723","6226"
"Esmeraldas",""," Total","21048","18691","39739"
"Esmeraldas","ESMERALDAS                    "," CAMARONES","1474","1343","2817"
"Esmeraldas",""," CHINCA","2369","2183","4552"
"Esmeraldas",""," CRNEL. CARLOS CONCHA TORRES","1308","1046","2354"
"Esmeraldas",""," ESMERALDAS","77505","84363","161868"
"Esmeraldas",""," MAJUA","1373","1161","2534"
"Esmeraldas",""," SAN MATEO","3153","2586","5739"
"Esmeraldas",""," TABIAZO","1384","1276","2660"
"Esmeraldas",""," TACHINA","2014","1969","3983"
"Esmeraldas",""," VUELTA LARGA","1496","1501","2997"
"Esmeraldas",""," Total","92076","97428","189504"
"Esmeraldas","LA CONCORDIA                  "," LA CONCORDIA","21748","21176","42924"
"Esmeraldas",""," Total","21748","21176","42924"
"Esmeraldas","MUISNE                        "," BOLIVAR","576","463","1039"
"Esmeraldas",""," DAULE","1209","944","2153"
"Esmeraldas",""," GALERA","970","763","1733"
"Esmeraldas",""," MUISNE","4563","4317","8880"
"Esmeraldas",""," QUINGUE (OLMEDO PERDOMO","307","267","574"
"Esmeraldas",""," SALIMA","599","518","1117"
"Esmeraldas",""," SAN FRANCISCO","1523","1286","2809"
"Esmeraldas",""," SAN GREGORIO","3207","2708","5915"
"Esmeraldas",""," SAN JOSE DE CHAMANGA","2390","1864","4254"
"Esmeraldas",""," Total","15344","13130","28474"
"Esmeraldas","QUININDE                      "," CHURA (CHANCAMA)","2617","2116","4733"
"Esmeraldas",""," CUBE","4108","3482","7590"
"Esmeraldas",""," LA UNION","10314","9610","19924"
"Esmeraldas",""," MALIMPIA","9621","8151","17772"
"Esmeraldas",""," ROSA ZARATE (QUININDE)","34758","32501","67259"
"Esmeraldas",""," VICHE","2723","2569","5292"
"Esmeraldas",""," Total","64141","58429","122570"
"Esmeraldas","RIOVERDE                      "," CHONTADURO","1743","1479","3222"
"Esmeraldas",""," CHUMUNDE","1905","1607","3512"
"Esmeraldas",""," LAGARTO","3049","2625","5674"
"Esmeraldas",""," MONTALVO","2106","1903","4009"
"Esmeraldas",""," RIOVERDE","2564","2400","4964"
"Esmeraldas",""," ROCAFUERTE","2805","2683","5488"
"Esmeraldas",""," Total","14172","12697","26869"
"Esmeraldas","SAN LORENZO                   "," 5 DE JUNIO","219","197","416"
"Esmeraldas",""," ALTO TAMBO","1001","870","1871"
"Esmeraldas",""," ANCON (PICHANGAL)","901","913","1814"
"Esmeraldas",""," CALDERON","330","298","628"
"Esmeraldas",""," CARONDELET","898","832","1730"
"Esmeraldas",""," CONCEPCION","1244","1110","2354"
"Esmeraldas",""," MATAJE","786","689","1475"
"Esmeraldas",""," SAN JAVIER DE CACHAVI","343","321","664"
"Esmeraldas",""," SAN LORENZO","12462","12634","25096"
"Esmeraldas",""," SANTA RITA","837","802","1639"
"Esmeraldas",""," TAMBILLO","926","817","1743"
"Esmeraldas",""," TULULBI","1181","1114","2295"
"Esmeraldas",""," URBINA","424","337","761"
"Esmeraldas",""," Total","21552","20934","42486"
"Esmeraldas","Total","","271312","262780","534092"
"Guayas","ALFREDO BAQUERIZO MORENO      "," ALFREDO BAQUERIZO MORENO","13013","12166","25179"
"Guayas",""," Total","13013","12166","25179"
"Guayas","BALAO                         "," BALAO","10998","9525","20523"
"Guayas",""," Total","10998","9525","20523"
"Guayas","BALZAR                        "," BALZAR","28001","25936","53937"
"Guayas",""," Total","28001","25936","53937"
"Guayas","COLIMES                       "," COLIMES","9147","8160","17307"
"Guayas",""," SAN JACINTO","3276","2840","6116"
"Guayas",""," Total","12423","11000","23423"
"Guayas","CORONEL MARCELINO MARIDUEÑA   "," CORONEL MARCELINO MARIDUEÑA","6265","5768","12033"
"Guayas",""," Total","6265","5768","12033"
"Guayas","DAULE                         "," DAULE","43372","44136","87508"
"Guayas",""," JUAN BAUTISTA AGUIRRE","2825","2677","5502"
"Guayas",""," LAUREL","5093","4789","9882"
"Guayas",""," LIMONAL","4497","4277","8774"
"Guayas",""," LOS LOJAS","4408","4252","8660"
"Guayas",""," Total","60195","60131","120326"
"Guayas","DURAN                         "," ELOY ALFARO (DURAN)","116401","119368","235769"
"Guayas",""," Total","116401","119368","235769"
"Guayas","EL EMPALME                    "," EL ROSARIO","4730","4475","9205"
"Guayas",""," GUAYAS (PUEBLO NUEVO)","9313","8266","17579"
"Guayas",""," VELASCO IBARRA","23981","23686","47667"
"Guayas",""," Total","38024","36427","74451"
"Guayas","EL TRIUNFO                    "," EL TRIUNFO","22824","21954","44778"
"Guayas",""," Total","22824","21954","44778"
"Guayas","GENERAL ANTONIO ELIZALDE      "," GENERAL ANTONIO ELIZALDE","5369","5273","10642"
"Guayas",""," Total","5369","5273","10642"
"Guayas","GUAYAQUIL                     "," GUAYAQUIL","1127137","1164021","2291158"
"Guayas",""," JUAN GOMEZ RENDON (PROGR","6134","5763","11897"
"Guayas",""," MORRO","2701","2318","5019"
"Guayas",""," POSORJA","12269","11867","24136"
"Guayas",""," PUNA","3640","3129","6769"
"Guayas",""," TENGUEL","6340","5596","11936"
"Guayas",""," Total","1158221","1192694","2350915"
"Guayas","ISIDRO AYORA                  "," ISIDRO AYORA","5585","5285","10870"
"Guayas",""," Total","5585","5285","10870"
"Guayas","LOMAS DE SARGENTILLO          "," LOMAS DE SARGENTILLO","9466","8947","18413"
"Guayas",""," Total","9466","8947","18413"
"Guayas","MILAGRO                       "," CHOBO","2772","2649","5421"
"Guayas",""," MARISCAL SUCRE (HUAQUES)","2827","2538","5365"
"Guayas",""," MILAGRO","72031","72994","145025"
"Guayas",""," ROBERTO ASTUDILLO","5611","5212","10823"
"Guayas",""," Total","83241","83393","166634"
"Guayas","NARANJAL                      "," JESUS MARIA","3486","2941","6427"
"Guayas",""," NARANJAL","20721","19118","39839"
"Guayas",""," SAN CARLOS","3530","2986","6516"
"Guayas",""," SANTA ROSA DE FLANDES","2917","2527","5444"
"Guayas",""," TAURA","5971","4815","10786"
"Guayas",""," Total","36625","32387","69012"
"Guayas","NARANJITO                     "," NARANJITO","19063","18123","37186"
"Guayas",""," Total","19063","18123","37186"
"Guayas","NOBOL                         "," NARCISA DE JESUS","9856","9744","19600"
"Guayas",""," Total","9856","9744","19600"
"Guayas","PALESTINA                     "," PALESTINA","8354","7711","16065"
"Guayas",""," Total","8354","7711","16065"
"Guayas","PEDRO CARBO                   "," PEDRO CARBO","16216","15101","31317"
"Guayas",""," SABANILLA","3635","3254","6889"
"Guayas",""," VALLE DE LA VIRGEN","2757","2473","5230"
"Guayas",""," Total","22608","20828","43436"
"Guayas","PLAYAS                        "," GENERAL VILLAMIL","21242","20693","41935"
"Guayas",""," Total","21242","20693","41935"
"Guayas","SAMBORONDON                   "," SAMBORONDON","25249","26385","51634"
"Guayas",""," TARIFA","8253","7703","15956"
"Guayas",""," Total","33502","34088","67590"
"Guayas","SANTA LUCIA                   "," SANTA LUCIA","20276","18647","38923"
"Guayas",""," Total","20276","18647","38923"
"Guayas","SIMON BOLIVAR                 "," CRNEL.LORENZO DE GARAICOA","5729","5169","10898"
"Guayas",""," SIMON BOLIVAR","7541","7044","14585"
"Guayas",""," Total","13270","12213","25483"
"Guayas","URBINA JADO                   "," EL SALITRE (LAS RAMAS)","14399","13718","28117"
"Guayas",""," GENERAL VERNAZA","5039","4472","9511"
"Guayas",""," JUNQUILLAL","6984","6320","13304"
"Guayas",""," LA VICTORIA (ÑAUZA)","3406","3064","6470"
"Guayas",""," Total","29828","27574","57402"
"Guayas","YAGUACHI                      "," GRAL. PEDRO J. MONTERO","4332","3863","8195"
"Guayas",""," VIRGEN DE FATIMA","7289","6900","14189"
"Guayas",""," YAGUACHI NUEVO","13429","13188","26617"
"Guayas",""," YAGUACHI VIEJO (CONE)","6214","5743","11957"
"Guayas",""," Total","31264","29694","60958"
"Guayas","Total","","1815914","1829569","3645483"
"Imbabura","ANTONIO ANTE                  "," ATUNTAQUI","11208","12091","23299"
"Imbabura",""," IMBAYA","652","627","1279"
"Imbabura",""," SAN FRANCISCO DE NATABUE","2719","2932","5651"
"Imbabura",""," SAN JOSE DE CHALTURA","1503","1644","3147"
"Imbabura",""," SAN ROQUE","4987","5155","10142"
"Imbabura",""," Total","21069","22449","43518"
"Imbabura","COTACACHI                     "," 6 DE JULIO DE CUELLAJE","936","844","1780"
"Imbabura",""," APUELA","942","882","1824"
"Imbabura",""," COTACACHI","8398","8741","17139"
"Imbabura",""," GARCIA MORENO","2675","2385","5060"
"Imbabura",""," IMANTAG","2424","2517","4941"
"Imbabura",""," PEÑAHERRERA","850","794","1644"
"Imbabura",""," PLAZA GUTIERREZ","260","236","496"
"Imbabura",""," QUIROGA","3210","3244","6454"
"Imbabura",""," VACAS GALINDO (EL CHURO)","395","303","698"
"Imbabura",""," Total","20090","19946","40036"
"Imbabura","IBARRA                        "," AMBUQUI","2707","2770","5477"
"Imbabura",""," ANGOCHAGUA","1510","1753","3263"
"Imbabura",""," CAROLINA","1448","1291","2739"
"Imbabura",""," IBARRA","67165","72556","139721"
"Imbabura",""," LA ESPERANZA","3686","3677","7363"
"Imbabura",""," LITA","1788","1561","3349"
"Imbabura",""," SALINAS","887","854","1741"
"Imbabura",""," SAN ANTONIO","8595","8927","17522"
"Imbabura",""," Total","87786","93389","181175"
"Imbabura","OTAVALO                       "," DR. MIGUEL EGAS CABEZAS","2344","2539","4883"
"Imbabura",""," EUGENIO ESPEJO (CALPAQUI)","3499","3858","7357"
"Imbabura",""," GONZALEZ SUAREZ","2753","2877","5630"
"Imbabura",""," OTAVALO","25274","27479","52753"
"Imbabura",""," PATAQUI","128","141","269"
"Imbabura",""," SAN JOSE DE QUICHINCHE","4142","4334","8476"
"Imbabura",""," SAN JUAN DE ILUMAN","4186","4398","8584"
"Imbabura",""," SAN PABLO","4701","5200","9901"
"Imbabura",""," SAN RAFAEL","2561","2860","5421"
"Imbabura",""," SELVA ALEGRE","858","742","1600"
"Imbabura",""," Total","50446","54428","104874"
"Imbabura","PIMAMPIRO                     "," CHUGA","577","503","1080"
"Imbabura",""," MARIANO ACOSTA","756","788","1544"
"Imbabura",""," PIMAMPIRO","4459","4618","9077"
"Imbabura",""," SAN FRANCISCO DE SIGSIPA","656","613","1269"
"Imbabura",""," Total","6448","6522","12970"
"Imbabura","SAN MIGUEL DE URCUQUI         "," CAHUASQUI","936","877","1813"
"Imbabura",""," LA MERCED DE BUENOS AIRES","989","904","1893"
"Imbabura",""," PABLO ARENAS","1068","1050","2118"
"Imbabura",""," SAN BLAS","1468","1547","3015"
"Imbabura",""," TUMBABIRO","816","811","1627"
"Imbabura",""," URCUQUI","2548","2657","5205"
"Imbabura",""," Total","7825","7846","15671"
"Imbabura","Total"," Total","193664","204580","398244"
"Loja","CALVAS                        "," CARIAMANGA","10402","10899","21301"
"Loja",""," COLAISACA","941","913","1854"
"Loja",""," EL LUCERO","1037","988","2025"
"Loja",""," SANGILLIN","866","802","1668"
"Loja",""," UTUANA","704","633","1337"
"Loja",""," Total","13950","14235","28185"
"Loja","CATAMAYO                      "," CATAMAYO (LA TOMA)","11577","11878","23455"
"Loja",""," EL TAMBO","2375","2255","4630"
"Loja",""," GUAYQUICHUMA","198","185","383"
"Loja",""," SAN PEDRO DE LA BENDITA","780","810","1590"
"Loja",""," ZAMBI","296","284","580"
"Loja",""," Total","15226","15412","30638"
"Loja","CELICA                        "," CELICA","3773","3550","7323"
"Loja",""," CRUZPAMBA","576","518","1094"
"Loja",""," POZUL (SAN JUAN DE POZUL","1520","1515","3035"
"Loja",""," SABANILLA","1318","1125","2443"
"Loja",""," TNTE. MAXIMILIANO RODRIG","319","254","573"
"Loja",""," Total","7506","6962","14468"
"Loja","CHAGUARPAMBA                  "," AMARILLOS","346","317","663"
"Loja",""," BUENAVISTA","627","587","1214"
"Loja",""," CHAGUARPAMBA","1877","1702","3579"
"Loja",""," EL ROSARIO","255","240","495"
"Loja",""," SANTA RUFINA","629","581","1210"
"Loja",""," Total","3734","3427","7161"
"Loja","ESPINDOLA                     "," 27 DE ABRIL","1084","1002","2086"
"Loja",""," AMALUZA","1745","1693","3438"
"Loja",""," BELLAVISTA","1219","1116","2335"
"Loja",""," EL AIRO","536","461","997"
"Loja",""," EL INGENIO","964","907","1871"
"Loja",""," JIMBURA","1169","1147","2316"
"Loja",""," SANTA TERESITA","881","875","1756"
"Loja",""," Total","7598","7201","14799"
"Loja","GONZANAMA                     "," CHANGAIMINA (LA LIBERTAD","1390","1361","2751"
"Loja",""," GONZANAMA","1205","1316","2521"
"Loja",""," NAMBACOLA","2291","2229","4520"
"Loja",""," PURUNUMA (EGUIGUREN)","404","352","756"
"Loja",""," SACAPALCA","1100","1068","2168"
"Loja",""," Total","6390","6326","12716"
"Loja","LOJA                          "," CHANTACO","560","617","1177"
"Loja",""," CHUQUIRIBAMBA","1140","1326","2466"
"Loja",""," EL CISNE","783","845","1628"
"Loja",""," GUALEL","950","1110","2060"
"Loja",""," JIMBILLA","563","551","1114"
"Loja",""," LOJA","86631","93986","180617"
"Loja",""," MALACATOS (VALLADOLID)","3577","3537","7114"
"Loja",""," QUINARA","720","664","1384"
"Loja",""," SAN LUCAS","2210","2463","4673"
"Loja",""," SAN PEDRO DE VILCABAMBA","650","639","1289"
"Loja",""," SANTIAGO","666","707","1373"
"Loja",""," TAQUIL (MIGUEL RIOFRIO)","1819","1844","3663"
"Loja",""," VILCABAMBA (VICTORIA)","2365","2413","4778"
"Loja",""," YANGANA (ARSENIO CASTILLO)","836","683","1519"
"Loja",""," Total","103470","111385","214855"
"Loja","MACARA                        "," LA VICTORIA","799","758","1557"
"Loja",""," LARAMA","564","516","1080"
"Loja",""," MACARA","7959","7771","15730"
"Loja",""," SABIANGO (LA CAPILLA)","327","324","651"
"Loja",""," Total","9649","9369","19018"
"Loja","OLMEDO                        "," LA TINGUE","360","308","668"
"Loja",""," OLMEDO","2062","2140","4202"
"Loja",""," Total","2422","2448","4870"
"Loja","PALTAS                        "," CANGONAMA","636","635","1271"
"Loja",""," CASANGA","931","874","1805"
"Loja",""," CATACOCHA","5943","6259","12202"
"Loja",""," GUACHANAMA","1383","1219","2602"
"Loja",""," LAURO GUERRERO","915","910","1825"
"Loja",""," ORIANGA","890","873","1763"
"Loja",""," SAN ANTONIO","563","528","1091"
"Loja",""," YAMANA","620","622","1242"
"Loja",""," Total","11881","11920","23801"
"Loja","PINDAL                        "," 12 DE DICIEMBRE","989","902","1891"
"Loja",""," CHAQUINAL","583","506","1089"
"Loja",""," PINDAL","2930","2735","5665"
"Loja",""," Total","4502","4143","8645"
"Loja","PUYANGO                       "," ALAMOR","4119","4177","8296"
"Loja",""," CIANO","721","705","1426"
"Loja",""," EL ARENAL","511","470","981"
"Loja",""," EL LIMO (MARIANA DE JESUS)","1290","1080","2370"
"Loja",""," MERCADILLO","599","575","1174"
"Loja",""," VICENTINO","646","620","1266"
"Loja",""," Total","7886","7627","15513"
"Loja","QUILANGA                      "," FUNDOCHAMBA","190","163","353"
"Loja",""," QUILANGA","1386","1335","2721"
"Loja",""," SAN ANTONIO DE LAS ARADAS","645","618","1263"
"Loja",""," Total","2221","2116","4337"
"Loja","SARAGURO                      "," EL PARAISO DE CELEN","1256","1501","2757"
"Loja",""," EL TABLON","437","480","917"
"Loja",""," LLUZHAPA","834","871","1705"
"Loja",""," MANU","1255","1413","2668"
"Loja",""," SAN ANTONIO DE QUMBE","530","616","1146"
"Loja",""," SAN PABLO DE TENTA","1747","1929","3676"
"Loja",""," SAN SEBASTIAN DE YULUC","479","503","982"
"Loja",""," SARAGURO","4228","4817","9045"
"Loja",""," SELVA ALEGRE","903","1024","1927"
"Loja",""," SUMAYPAMBA","769","825","1594"
"Loja",""," URDANETA (PAQUISHAPA)","1685","2081","3766"
"Loja",""," Total","14123","16060","30183"
"Loja","SOZORANGA                     "," NUEVA FATIMA","466","437","903"
"Loja",""," SOZORANGA","1974","1787","3761"
"Loja",""," TACAMOROS","1355","1446","2801"
"Loja",""," Total","3795","3670","7465"
"Loja","ZAPOTILLO                     "," BOLASPAMBA","594","492","1086"
"Loja",""," CAZADEROS","638","534","1172"
"Loja",""," GARZAREAL","962","820","1782"
"Loja",""," LIMONES","747","663","1410"
"Loja",""," PALETILLAS","1379","1252","2631"
"Loja",""," ZAPOTILLO","2121","2110","4231"
"Loja",""," Total","6441","5871","12312"
"Loja","Total","","220794","228172","448966"
"Los Rios","BABA                          "," BABA","9845","8998","18843"
"Los Rios",""," GUARE","6067","5380","11447"
"Los Rios",""," ISLA DE BEJUCAL","4853","4538","9391"
"Los Rios",""," Total","20765","18916","39681"
"Los Rios","BABAHOYO                      "," BABAHOYO","48220","48736","96956"
"Los Rios",""," CARACOL","2688","2424","5112"
"Los Rios",""," FEBRES CORDERO (LAS JUNTAS)","9442","8543","17985"
"Los Rios",""," LA UNION","6635","6062","12697"
"Los Rios",""," PIMOCHA","10982","10044","21026"
"Los Rios",""," Total","77967","75809","153776"
"Los Rios","BUENA FE                      "," PATRICIA PILAR","6441","5837","12278"
"Los Rios",""," SAN JACINTO DE BUENA FE","26208","24662","50870"
"Los Rios",""," Total","32649","30499","63148"
"Los Rios","MOCACHE                       "," MOCACHE","19996","18396","38392"
"Los Rios",""," Total","19996","18396","38392"
"Los Rios","MONTALVO                      "," MONTALVO","12298","11866","24164"
"Los Rios",""," Total","12298","11866","24164"
"Los Rios","PALENQUE                      "," PALENQUE","11841","10479","22320"
"Los Rios",""," Total","11841","10479","22320"
"Los Rios","PUEBLOVIEJO                   "," PUEBLOVIEJO","6828","6548","13376"
"Los Rios",""," PUERTO PECHICHE","2412","2262","4674"
"Los Rios",""," SAN JUAN","9374","9053","18427"
"Los Rios",""," Total","18614","17863","36477"
"Los Rios","QUEVEDO                       "," LA ESPERANZA","2509","2344","4853"
"Los Rios",""," QUEVEDO","79218","79476","158694"
"Los Rios",""," SAN CARLOS","5094","4934","10028"
"Los Rios",""," Total","86821","86754","173575"
"Los Rios","QUINSALOMA                    "," QUINSALOMA","8627","7849","16476"
"Los Rios",""," Total","8627","7849","16476"
"Los Rios","URDANETA                      "," CATARAMA","4305","4286","8591"
"Los Rios",""," RICAURTE","10758","9914","20672"
"Los Rios",""," Total","15063","14200","29263"
"Los Rios","VALENCIA                      "," VALENCIA","22592","19964","42556"
"Los Rios",""," Total","22592","19964","42556"
"Los Rios","VENTANAS                      "," VENTANAS","22916","22735","45651"
"Los Rios",""," ZAPOTAL","10869","10031","20900"
"Los Rios",""," Total","33785","32766","66551"
"Los Rios","VINCES                        "," ANTONIO SOTOMAYOR","8673","7620","16293"
"Los Rios",""," VINCES","28408","27035","55443"
"Los Rios",""," Total","37081","34655","71736"
"Los Rios","Total","","398099","380016","778115"
"Manabi","24 DE MAYO                    "," ARQ. SIXTO DURAN BALLEN","2091","1861","3952"
"Manabi",""," BELLAVISTA","2512","2408","4920"
"Manabi",""," NOBOA","3440","3108","6548"
"Manabi",""," SUCRE","6858","6568","13426"
"Manabi",""," Total","14901","13945","28846"
"Manabi","BOLIVAR                       "," CALCETA","16660","16755","33415"
"Manabi",""," MEMBRILLO","1849","1704","3553"
"Manabi",""," QUIROGA","2305","1462","3767"
"Manabi",""," Total","20814","19921","40735"
"Manabi","CHONE                         "," BOYACA","2377","2124","4501"
"Manabi",""," CANUTO","5212","5143","10355"
"Manabi",""," CHIBUNGA","3455","2905","6360"
"Manabi",""," CHONE","36669","38237","74906"
"Manabi",""," CONVENTO","3424","3154","6578"
"Manabi",""," ELOY ALFARO","4036","3796","7832"
"Manabi",""," RICAURTE","4047","3873","7920"
"Manabi",""," SAN ANTONIO","4063","3976","8039"
"Manabi",""," Total","63283","63208","126491"
"Manabi","EL CARMEN                     "," EL CARMEN","39567","38176","77743"
"Manabi",""," SAN PEDRO DE SUMA","3521","3171","6692"
"Manabi",""," WILFRIDO LOOR MOREIRA","2429","2157","4586"
"Manabi",""," Total","45517","43504","89021"
"Manabi","FLAVIO ALFARO                 "," FLAVIO ALFARO","9500","9036","18536"
"Manabi",""," SAN FRANCISCO DE NOVILLO","1502","1277","2779"
"Manabi",""," ZAPALLO","1907","1782","3689"
"Manabi",""," Total","12909","12095","25004"
"Manabi","JAMA                          "," JAMA","11850","11403","23253"
"Manabi",""," Total","11850","11403","23253"
"Manabi","JARAMIJO                      "," JARAMIJO","9511","8975","18486"
"Manabi",""," Total","9511","8975","18486"
"Manabi","JIPIJAPA                      "," AMERICA","1638","1422","3060"
"Manabi",""," EL ANEGADO","3656","3208","6864"
"Manabi",""," JIPIJAPA","24301","24775","49076"
"Manabi",""," JULCUY","1150","1025","2175"
"Manabi",""," LA UNION","1062","879","1941"
"Manabi",""," MEMBRILLAL","560","445","1005"
"Manabi",""," PEDRO PABLO GOMEZ","1897","1667","3564"
"Manabi",""," PUERTO DE CAYO","1807","1591","3398"
"Manabi",""," Total","36071","35012","71083"
"Manabi","JUNIN                         "," JUNIN","9750","9192","18942"
"Manabi",""," Total","9750","9192","18942"
"Manabi","MANTA                         "," MANTA","108677","112445","221122"
"Manabi",""," SAN LORENZO","1374","1273","2647"
"Manabi",""," SANTA MARIANITA","1352","1356","2708"
"Manabi",""," Total","111403","115074","226477"
"Manabi","MONTECRISTI                   "," LA PILA","1286","1166","2452"
"Manabi",""," MONTECRISTI","34018","33824","67842"
"Manabi",""," Total","35304","34990","70294"
"Manabi","OLMEDO                        "," OLMEDO","5083","4761","9844"
"Manabi",""," Total","5083","4761","9844"
"Manabi","PAJAN                         "," CAMPOZANO","4530","3977","8507"
"Manabi",""," CASCOL","3917","3275","7192"
"Manabi",""," GUALE","2043","1888","3931"
"Manabi",""," LASCANO","2732","2445","5177"
"Manabi",""," PAJAN","6307","5959","12266"
"Manabi",""," Total","19529","17544","37073"
"Manabi","PEDERNALES                    "," 10 DE AGOSTO","2680","2532","5212"
"Manabi",""," ATAHUALPA","1310","1258","2568"
"Manabi",""," COJIMIES","7241","6467","13708"
"Manabi",""," PEDERNALES","17189","16451","33640"
"Manabi",""," Total","28420","26708","55128"
"Manabi","PICHINCHA                     "," BARRAGANETE","4010","3557","7567"
"Manabi",""," PICHINCHA","9000","8416","17416"
"Manabi",""," SAN SEBASTIAN","2663","2598","5261"
"Manabi",""," Total","15673","14571","30244"
"Manabi","PORTOVIEJO                    "," ABDON CALDERON","7204","6960","14164"
"Manabi",""," ALHAJUELA (BAJO GRANDE)","1844","1910","3754"
"Manabi",""," CHIRIJOS","1204","1158","2362"
"Manabi",""," CRUCITA","7184","6866","14050"
"Manabi",""," PORTOVIEJO","108878","114208","223086"
"Manabi",""," PUEBLO NUEVO","1645","1524","3169"
"Manabi",""," RIOCHICO (RIO CHICO)","6155","5602","11757"
"Manabi",""," SAN PLACIDO","3855","3832","7687"
"Manabi",""," Total","137969","142060","280029"
"Manabi","PUERTO LOPEZ                  "," MACHALILLA","2568","2421","4989"
"Manabi",""," PUERTO LOPEZ","5647","5281","10928"
"Manabi",""," SALANGO","2349","2185","4534"
"Manabi",""," Total","10564","9887","20451"
"Manabi","ROCAFUERTE                    "," ROCAFUERTE","16922","16547","33469"
"Manabi",""," Total","16922","16547","33469"
"Manabi","SAN VICENTE                   "," CANOA","3663","3224","6887"
"Manabi",""," SAN VICENTE","7601","7537","15138"
"Manabi",""," Total","11264","10761","22025"
"Manabi","SANTA ANA                     "," AYACUCHO","3729","3694","7423"
"Manabi",""," HONORATO VASQUEZ","2994","2892","5886"
"Manabi",""," LA UNION","3354","3112","6466"
"Manabi",""," SAN PABLO","2802","2510","5312"
"Manabi",""," SANTA ANA DE VUELTA LARGA","11214","11084","22298"
"Manabi",""," Total","24093","23292","47385"
"Manabi","SUCRE                         "," BAHIA DE CARAQUEZ","13075","13037","26112"
"Manabi",""," CHARAPOTO","10216","9844","20060"
"Manabi",""," SAN ISIDRO","5651","5336","10987"
"Manabi",""," Total","28942","28217","57159"
"Manabi","TOSAGUA                       "," ANGEL PEDRO GILER","3212","3070","6282"
"Manabi",""," BACHILLERO","1979","1906","3885"
"Manabi",""," TOSAGUA","14336","13838","28174"
"Manabi",""," Total","19527","18814","38341"
"Manabi","Total"," Total","689299","680481","1369780"
"Morona Santiago","GUALAQUIZA                    "," AMAZONAS (ROSARIO DE CUYES)","201","211","412"
"Morona Santiago",""," BERMEJOS","119","104","223"
"Morona Santiago",""," BOMBOIZA","2341","2282","4623"
"Morona Santiago",""," CHIGUINDA","266","286","552"
"Morona Santiago",""," EL IDEAL","425","396","821"
"Morona Santiago",""," EL ROSARIO","303","305","608"
"Morona Santiago",""," GUALAQUIZA","4694","4534","9228"
"Morona Santiago",""," NUEVA TARQUI","252","259","511"
"Morona Santiago",""," SAN MIGUEL DE CUYES","96","88","184"
"Morona Santiago",""," Total","8697","8465","17162"
"Morona Santiago","HUAMBOYA                      "," CHIGUAZA","3000","2928","5928"
"Morona Santiago",""," HUAMBOYA","1316","1222","2538"
"Morona Santiago",""," Total","4316","4150","8466"
"Morona Santiago","LIMON INDANZA                 "," GENERAL LEONIDAS PLAZA G.","1920","2061","3981"
"Morona Santiago",""," INDANZA","704","659","1363"
"Morona Santiago",""," SAN ANTONIO","1073","1084","2157"
"Morona Santiago",""," SAN MIGUEL DE CONCHAY","207","198","405"
"Morona Santiago",""," SANTA SUSANA DE CHIVIAZA","386","386","772"
"Morona Santiago",""," YUNGANZA","522","522","1044"
"Morona Santiago",""," Total","4812","4910","9722"
"Morona Santiago","LOGROÑO                       "," LOGROÑO","1054","999","2053"
"Morona Santiago",""," SHIMPIS","960","933","1893"
"Morona Santiago",""," YAUPI","859","918","1777"
"Morona Santiago",""," Total","2873","2850","5723"
"Morona Santiago","MORONA                        "," ALSHI","238","187","425"
"Morona Santiago",""," CUCHAENTZA","909","876","1785"
"Morona Santiago",""," GENERAL PROAÑO","1276","1314","2590"
"Morona Santiago",""," MACAS","9637","9539","19176"
"Morona Santiago",""," RIO BLANCO","982","1010","1992"
"Morona Santiago",""," SAN ISIDRO","387","398","785"
"Morona Santiago",""," SEVILLA DON BOSCO","6686","6727","13413"
"Morona Santiago",""," SINAI","383","383","766"
"Morona Santiago",""," ZUÑA (ZUÑAC)","113","110","223"
"Morona Santiago",""," Total","20611","20544","41155"
"Morona Santiago","PABLO VI                      "," PABLO VI","941","882","1823"
"Morona Santiago",""," Total","941","882","1823"
"Morona Santiago","PALORA                        "," 16 DE AGOSTO","517","473","990"
"Morona Santiago",""," ARAPICOS","258","224","482"
"Morona Santiago",""," CUMANDA","187","158","345"
"Morona Santiago",""," PALORA (METZERA)","1975","1972","3947"
"Morona Santiago",""," SANGAY","609","563","1172"
"Morona Santiago",""," Total","3546","3390","6936"
"Morona Santiago","SAN JUAN BOSCO                "," PAN DE AZUCAR","142","123","265"
"Morona Santiago",""," SAN CARLOS DE LIMON","412","381","793"
"Morona Santiago",""," SAN JACINTO DE WAKAMBEIS","105","99","204"
"Morona Santiago",""," SAN JUAN BOSCO","1071","1106","2177"
"Morona Santiago",""," SANTIAGO DE PANANZA","245","224","469"
"Morona Santiago",""," Total","1975","1933","3908"
"Morona Santiago","SANTIAGO                      "," CHUPIANZA","248","219","467"
"Morona Santiago",""," COPAL","274","206","480"
"Morona Santiago",""," PATUCA","1198","935","2133"
"Morona Santiago",""," SAN FRANCISCO DE CHINIMB","521","558","1079"
"Morona Santiago",""," SAN LUIS DE EL ACHO","313","305","618"
"Morona Santiago",""," SANTIAGO","804","706","1510"
"Morona Santiago",""," SANTIAGO DE MENDEZ","1501","1507","3008"
"Morona Santiago",""," Total","4859","4436","9295"
"Morona Santiago","SUCUA                         "," ASUNCION","925","978","1903"
"Morona Santiago",""," HUAMBI","1429","1462","2891"
"Morona Santiago",""," SANTA MARIANITA DE JESUS","444","461","905"
"Morona Santiago",""," SUCUA","6174","6445","12619"
"Morona Santiago",""," Total","8972","9346","18318"
"Morona Santiago","TAISHA                        "," HUASAGA","730","779","1509"
"Morona Santiago",""," MACUMA","1943","1942","3885"
"Morona Santiago",""," PUMPUENTSA","1231","1222","2453"
"Morona Santiago",""," TAISHA","3126","2823","5949"
"Morona Santiago",""," TUTINENTZA","2338","2303","4641"
"Morona Santiago",""," Total","9368","9069","18437"
"Morona Santiago","TIWINTZA                      "," SAN JOSE DE MORONA","1210","1064","2274"
"Morona Santiago",""," TIWINTZA","2669","2052","4721"
"Morona Santiago",""," Total","3879","3116","6995"
"Morona Santiago","Total","","74849","73091","147940"
"Napo","ARCHIDONA                     "," ARCHIDONA","5821","5868","11689"
"Napo",""," COTUNDO","4252","4124","8376"
"Napo",""," SAN PABLO DE USHPAYACU","2560","2344","4904"
"Napo",""," Total","12633","12336","24969"
"Napo","CARLOS JULIO AROSEMENA        "," CARLOS JULIO AROSEMENA TOLA","1934","1730","3664"
"Napo",""," Total","1934","1730","3664"
"Napo","EL CHACO                      "," EL CHACO","2430","2386","4816"
"Napo",""," GONZALO DIAZ DE PINEDA","299","236","535"
"Napo",""," LINARES","113","96","209"
"Napo",""," OYACACHI","315","305","620"
"Napo",""," SANTA ROSA","685","558","1243"
"Napo",""," SARDINAS","286","251","537"
"Napo",""," Total","4128","3832","7960"
"Napo","QUIJOS                        "," BAEZA","970","976","1946"
"Napo",""," COSANGA","288","217","505"
"Napo",""," CUYUJA","315","299","614"
"Napo",""," PAPALLACTA","492","428","920"
"Napo",""," SAN FRANCISCO DE BORJA","1052","1148","2200"
"Napo",""," SUMACO","19","20","39"
"Napo",""," Total","3136","3088","6224"
"Napo","TENA                          "," AHUANO","2873","2706","5579"
"Napo",""," CHONTAPUNTA","3559","3128","6687"
"Napo",""," PANO","694","698","1392"
"Napo",""," PUERTO MISAHUALLI","2668","2459","5127"
"Napo",""," PUERTO NAPO","2796","2597","5393"
"Napo",""," TALAG","1431","1337","2768"
"Napo",""," TENA","16922","17012","33934"
"Napo",""," Total","30943","29937","60880"
"Napo","Total","","52774","50923","103697"
"Pastaza","ARAJUNO                       "," ARAJUNO","1979","1827","3806"
"Pastaza",""," CURARAY","1423","1262","2685"
"Pastaza",""," Total","3402","3089","6491"
"Pastaza","MERA                          "," MADRE TIERRA","794","794","1588"
"Pastaza",""," MERA","754","767","1521"
"Pastaza",""," SHELL","4531","4221","8752"
"Pastaza",""," Total","6079","5782","11861"
"Pastaza","PASTAZA                       "," CANELOS","1096","1077","2173"
"Pastaza",""," DIEZ DE AGOSTO","606","538","1144"
"Pastaza",""," EL TRIUNFO","685","640","1325"
"Pastaza",""," FATIMA","447","416","863"
"Pastaza",""," MONTALVO (ANDOAS)","2019","1830","3849"
"Pastaza",""," POMONA","131","106","237"
"Pastaza",""," PUYO","17979","18680","36659"
"Pastaza",""," RIO CORRIENTES","111","124","235"
"Pastaza",""," RIO TIGRE","339","317","656"
"Pastaza",""," SARAYACU","1271","1285","2556"
"Pastaza",""," SIMON BOLIVAR","2817","2865","5682"
"Pastaza",""," TARQUI","1963","1868","3831"
"Pastaza",""," TENIENTE HUGO ORTIZ","553","495","1048"
"Pastaza",""," VERACRUZ (INDILLAMA)","906","852","1758"
"Pastaza",""," Total","30923","31093","62016"
"Pastaza","SANTA CLARA                   "," SAN JOSE","386","349","735"
"Pastaza",""," SANTA CLARA","1470","1360","2830"
"Pastaza",""," Total","1856","1709","3565"
"Pastaza","Total","","42260","41673","83933"
"Pichincha","CAYAMBE                       "," ASCAZUBI","2499","2551","5050"
"Pichincha",""," CANGAHUA","7920","8311","16231"
"Pichincha",""," CAYAMBE","24989","25840","50829"
"Pichincha",""," OLMEDO (PESILLO)","3162","3610","6772"
"Pichincha",""," OTON","1357","1409","2766"
"Pichincha",""," SANTA ROSA DE CUZUBAMBA","2040","2107","4147"
"Pichincha",""," Total","41967","43828","85795"
"Pichincha","MEJIA                         "," ALOAG","4509","4728","9237"
"Pichincha",""," ALOASI","4635","5051","9686"
"Pichincha",""," CUTUGLAHUA","8220","8526","16746"
"Pichincha",""," EL CHAUPI","710","746","1456"
"Pichincha",""," MACHACHI","13438","14185","27623"
"Pichincha",""," MANUEL CORNEJO ASTORGA","1944","1717","3661"
"Pichincha",""," TAMBILLO","4068","4251","8319"
"Pichincha",""," UYUMBICHO","2259","2348","4607"
"Pichincha",""," Total","39783","41552","81335"
"Pichincha","PEDRO MONCAYO                 "," LA ESPERANZA","1943","2043","3986"
"Pichincha",""," MALCHINGUI","2280","2344","4624"
"Pichincha",""," TABACUNDO","8163","8240","16403"
"Pichincha",""," TOCACHI","997","988","1985"
"Pichincha",""," TUPIGACHI","2928","3246","6174"
"Pichincha",""," Total","16311","16861","33172"
"Pichincha","PEDRO VICENTE MALDONADO       "," PEDRO VICENTE MALDONADO","6735","6189","12924"
"Pichincha",""," Total","6735","6189","12924"
"Pichincha","PUERTO QUITO                  "," PUERTO QUITO","10774","9671","20445"
"Pichincha",""," Total","10774","9671","20445"
"Pichincha","QUITO                         "," ALANGASI","11851","12400","24251"
"Pichincha",""," AMAGUAÑA","15395","15711","31106"
"Pichincha",""," ATAHUALPA (HABASPAMBA)","947","954","1901"
"Pichincha",""," CALACALI","1947","1948","3895"
"Pichincha",""," CALDERON (CARAPUNGO)","74682","77560","152242"
"Pichincha",""," CHAVEZPAMBA","403","398","801"
"Pichincha",""," CHECA (CHILPA)","4532","4448","8980"
"Pichincha",""," CONOCOTO","39691","42381","82072"
"Pichincha",""," CUMBAYA","15248","16215","31463"
"Pichincha",""," EL QUINCHE","8015","8041","16056"
"Pichincha",""," GUALEA","1073","952","2025"
"Pichincha",""," GUANGOPOLO","1528","1531","3059"
"Pichincha",""," GUAYLLABAMBA","8199","8014","16213"
"Pichincha",""," LA MERCED","4122","4272","8394"
"Pichincha",""," LLANO CHICO","5205","5468","10673"
"Pichincha",""," LLOA","784","710","1494"
"Pichincha",""," NANEGAL","1417","1219","2636"
"Pichincha",""," NANEGALITO","1555","1471","3026"
"Pichincha",""," NAYON","7628","8007","15635"
"Pichincha",""," NONO","910","822","1732"
"Pichincha",""," PACTO","2543","2255","4798"
"Pichincha",""," PERUCHO","407","382","789"
"Pichincha",""," PIFO","8235","8410","16645"
"Pichincha",""," PINTAG","8815","9115","17930"
"Pichincha",""," POMASQUI","14101","14809","28910"
"Pichincha",""," PUELLARO","2772","2716","5488"
"Pichincha",""," PUEMBO","6809","6784","13593"
"Pichincha",""," QUITO","783616","835530","1619146"
"Pichincha",""," SAN ANTONIO","15912","16445","32357"
"Pichincha",""," SAN JOSE DE MINAS","3775","3468","7243"
"Pichincha",""," TABABELA","1400","1423","2823"
"Pichincha",""," TUMBACO","24448","25496","49944"
"Pichincha",""," YARUQUI","8877","8977","17854"
"Pichincha",""," ZAMBIZA","1969","2048","4017"
"Pichincha",""," Total","1088811","1150380","2239191"
"Pichincha","RUMIÑAHUI                     "," COTOGCHOA","1949","1988","3937"
"Pichincha",""," RUMIPAMBA","399","376","775"
"Pichincha",""," SANGOLQUI","39569","41571","81140"
"Pichincha",""," Total","41917","43935","85852"
"Pichincha","SAN MIGUEL DE LOS BANCOS      "," MINDO","1991","1851","3842"
"Pichincha",""," SAN MIGUEL DE LOS BANCOS","7422","6309","13731"
"Pichincha",""," Total","9413","8160","17573"
"Pichincha","Total","","1255711","1320576","2576287"
"Tungurahua","AMBATO                        "," AMBATILLO","2598","2645","5243"
"Tungurahua",""," AMBATO","86299","92239","178538"
"Tungurahua",""," ATAHUALPA (CHISALATA)","4998","5263","10261"
"Tungurahua",""," AUGUSTO N. MARTINEZ","3962","4229","8191"
"Tungurahua",""," CONSTANTINO FERNANDEZ","1255","1279","2534"
"Tungurahua",""," CUNCHIBAMBA","2107","2368","4475"
"Tungurahua",""," HUACHI GRANDE","5187","5427","10614"
"Tungurahua",""," IZAMBA","7111","7452","14563"
"Tungurahua",""," JUAN BENIGNO VELA","3587","3869","7456"
"Tungurahua",""," MONTALVO","1961","1951","3912"
"Tungurahua",""," PASA","3220","3279","6499"
"Tungurahua",""," PICAIGUA","4022","4261","8283"
"Tungurahua",""," PILAGUIN (PILAHUIN)","5868","6260","12128"
"Tungurahua",""," QUISAPINCHA (QUIZAPINCHA)","6235","6766","13001"
"Tungurahua",""," SAN BARTOLOME DE PINLLOG","4437","4657","9094"
"Tungurahua",""," SAN FERNANDO","1176","1315","2491"
"Tungurahua",""," SANTA ROSA","10163","10840","21003"
"Tungurahua",""," TOTORAS","3394","3504","6898"
"Tungurahua",""," UNAMUNCHO","2250","2422","4672"
"Tungurahua",""," Total","159830","170026","329856"
"Tungurahua","BAÑOS                         "," BAÑOS","7318","7335","14653"
"Tungurahua",""," LLIGUA","138","142","280"
"Tungurahua",""," RIO NEGRO","638","608","1246"
"Tungurahua",""," RIO VERDE","669","638","1307"
"Tungurahua",""," ULBA","1271","1261","2532"
"Tungurahua",""," Total","10034","9984","20018"
"Tungurahua","CEVALLOS                      "," CEVALLOS","4028","4135","8163"
"Tungurahua",""," Total","4028","4135","8163"
"Tungurahua","MOCHA                         "," MOCHA","2698","2806","5504"
"Tungurahua",""," PINGUILI","658","615","1273"
"Tungurahua",""," Total","3356","3421","6777"
"Tungurahua","PATATE                        "," EL TRIUNFO","810","773","1583"
"Tungurahua",""," LOS ANDES","697","694","1391"
"Tungurahua",""," PATATE","4068","4086","8154"
"Tungurahua",""," SUCRE","1145","1224","2369"
"Tungurahua",""," Total","6720","6777","13497"
"Tungurahua","QUERO                         "," QUERO","7027","7227","14254"
"Tungurahua",""," RUMIPAMBA","1460","1513","2973"
"Tungurahua",""," YANAYACU - MOCHAPATA","1002","976","1978"
"Tungurahua",""," Total","9489","9716","19205"
"Tungurahua","SAN PEDRO DE PELILEO          "," BENITEZ (PACHANLICA)","1082","1101","2183"
"Tungurahua",""," BOLIVAR","1316","1397","2713"
"Tungurahua",""," CHIQUICHA","1163","1282","2445"
"Tungurahua",""," COTALO","944","908","1852"
"Tungurahua",""," EL ROSARIO (RUMICHACA)","1269","1369","2638"
"Tungurahua",""," GARCIA MORENO (CHUMAQUI)","3056","3324","6380"
"Tungurahua",""," GUAMBALO (HUAMBALO)","3883","3979","7862"
"Tungurahua",""," PELILEO","11830","12784","24614"
"Tungurahua",""," SALASACA","2784","3102","5886"
"Tungurahua",""," Total","27327","29246","56573"
"Tungurahua","SANTIAGO DE PILLARO           "," BAQUERIZO MORENO","132","145","277"
"Tungurahua",""," EMILIO MARIA TERAN","733","771","1504"
"Tungurahua",""," MARCOS ESPINEL (CHACATA)","1100","1234","2334"
"Tungurahua",""," PILLARO","6313","7070","13383"
"Tungurahua",""," PRESIDENTE URBINA","1290","1510","2800"
"Tungurahua",""," SAN ANDRES","5248","5952","11200"
"Tungurahua",""," SAN JOSE DE POALO","915","965","1880"
"Tungurahua",""," SAN MIGUELITO","2360","2619","4979"
"Tungurahua",""," Total","18091","20266","38357"
"Tungurahua","TISALEO                       "," QUINCHICOTO","633","673","1306"
"Tungurahua",""," TISALEO","5275","5556","10831"
"Tungurahua",""," Total","5908","6229","12137"
"Tungurahua","Total"," Total","244783","259800","504583"
"Zamora Chinchipe","CENTINELA DEL CONDOR          "," ZUMBI","3381","3098","6479"
"Zamora Chinchipe",""," Total","3381","3098","6479"
"Zamora Chinchipe","CHINCHIPE                     "," CHITO","663","567","1230"
"Zamora Chinchipe",""," EL CHORRO","126","90","216"
"Zamora Chinchipe",""," LA CHONTA","141","120","261"
"Zamora Chinchipe",""," PUCAPAMBA","81","37","118"
"Zamora Chinchipe",""," SAN ANDRES","241","175","416"
"Zamora Chinchipe",""," ZUMBA","3681","3197","6878"
"Zamora Chinchipe",""," Total","4933","4186","9119"
"Zamora Chinchipe","EL PANGUI                     "," EL GUISMI","798","806","1604"
"Zamora Chinchipe",""," EL PANGUI","2492","2496","4988"
"Zamora Chinchipe",""," PACHICUTZA","654","636","1290"
"Zamora Chinchipe",""," TUNDAYME","394","343","737"
"Zamora Chinchipe",""," Total","4338","4281","8619"
"Zamora Chinchipe","NANGARITZA                    "," GUAYZIMI","1337","1261","2598"
"Zamora Chinchipe",""," NUEVO PARAISO","312","282","594"
"Zamora Chinchipe",""," ZURMI","1039","965","2004"
"Zamora Chinchipe",""," Total","2688","2508","5196"
"Zamora Chinchipe","PALANDA                       "," EL PORVENIR DEL CARMEN","793","691","1484"
"Zamora Chinchipe",""," LA CANELA","192","163","355"
"Zamora Chinchipe",""," PALANDA","1903","1798","3701"
"Zamora Chinchipe",""," SAN FRANCISCO DE VERGEL","690","628","1318"
"Zamora Chinchipe",""," VALLADOLID","668","563","1231"
"Zamora Chinchipe",""," Total","4246","3843","8089"
"Zamora Chinchipe","PAQUISHA                      "," BELLAVISTA","149","152","301"
"Zamora Chinchipe",""," NUEVO QUITO","1258","843","2101"
"Zamora Chinchipe",""," PAQUISHA","750","702","1452"
"Zamora Chinchipe",""," Total","2157","1697","3854"
"Zamora Chinchipe","YACUAMBI                      "," 28 DE MAYO","1587","1566","3153"
"Zamora Chinchipe",""," LA PAZ","1029","1014","2043"
"Zamora Chinchipe",""," TUTUPALI","322","317","639"
"Zamora Chinchipe",""," Total","2938","2897","5835"
"Zamora Chinchipe","YANTZAZA                      "," CHICAÑA","1330","1331","2661"
"Zamora Chinchipe",""," LOS ENCUENTROS","1940","1718","3658"
"Zamora Chinchipe",""," YANZATZA","6186","6170","12356"
"Zamora Chinchipe",""," Total","9456","9219","18675"
"Zamora Chinchipe","ZAMORA                        "," CUMBARATZA","2259","2157","4416"
"Zamora Chinchipe",""," GUADALUPE","1412","1445","2857"
"Zamora Chinchipe",""," IMBANA","567","559","1126"
"Zamora Chinchipe",""," SABANILLA","301","283","584"
"Zamora Chinchipe",""," SAN CARLOS DE LAS MINAS","1280","900","2180"
"Zamora Chinchipe",""," TIMBARA","494","466","960"
"Zamora Chinchipe",""," ZAMORA","7002","6385","13387"
"Zamora Chinchipe",""," Total","13315","12195","25510"
"Zamora Chinchipe","Total","","47452","43924","91376"
"Galápagos","ISABELA                       "," PUERTO VILLAMIL","1105","987","2092"
"Galápagos",""," TOMAS DE BERLANGA","97","67","164"
"Galápagos",""," Total","1202","1054","2256"
"Galápagos","SAN CRISTOBAL                 "," EL PROGRESO","401","257","658"
"Galápagos",""," ISLA SANTA MARIA (FLOREANA)","88","57","145"
"Galápagos",""," PUERTO BAQUERIZO MORENO","3498","3174","6672"
"Galápagos",""," Total","3987","3488","7475"
"Galápagos","SANTA CRUZ                    "," BELLAVISTA","1251","1174","2425"
"Galápagos",""," PUERTO AYORA","6064","5910","11974"
"Galápagos",""," SANTA ROSA","517","477","994"
"Galápagos",""," Total","7832","7561","15393"
"Galápagos","Total","","13021","12103","25124"
"Sucumbíos","CASCALES                      "," EL DORADO DE CASCALES","3955","3619","7574"
"Sucumbíos",""," SANTA ROSA DE SUCUMBIOS","442","339","781"
"Sucumbíos",""," SEVILLA","1410","1339","2749"
"Sucumbíos",""," Total","5807","5297","11104"
"Sucumbíos","CUYABENO                      "," AGUAS NEGRAS","771","692","1463"
"Sucumbíos",""," CUYABENO","219","173","392"
"Sucumbíos",""," TARAPOA","3042","2236","5278"
"Sucumbíos",""," Total","4032","3101","7133"
"Sucumbíos","GONZALO PIZARRO               "," EL REVENTADOR","802","699","1501"
"Sucumbíos",""," GONZALO PIZARRO","1503","1452","2955"
"Sucumbíos",""," LUMBAQUI","1724","1501","3225"
"Sucumbíos",""," PUERTO LIBRE","494","424","918"
"Sucumbíos",""," Total","4523","4076","8599"
"Sucumbíos","LAGO AGRIO                    "," DURENO","1431","1325","2756"
"Sucumbíos",""," EL ENO","3424","3212","6636"
"Sucumbíos",""," GENERAL FARFAN","3691","3078","6769"
"Sucumbíos",""," JAMBELI","1772","1543","3315"
"Sucumbíos",""," NUEVA LOJA","29017","28710","57727"
"Sucumbíos",""," PACAYACU","4440","3809","8249"
"Sucumbíos",""," STA. CECILIA","3191","3101","6292"
"Sucumbíos",""," Total","46966","44778","91744"
"Sucumbíos","PUTUMAYO                      "," PALMA ROJA","2132","1822","3954"
"Sucumbíos",""," PUERTO BOLIVAR","240","39","279"
"Sucumbíos",""," PUERTO EL CARMEN DEL PUTUMAYO","1818","1633","3451"
"Sucumbíos",""," PUERTO RODRIGUEZ","312","184","496"
"Sucumbíos",""," SANTA ELENA","1093","901","1994"
"Sucumbíos",""," Total","5595","4579","10174"
"Sucumbíos","SHUSHUFINDI                   "," LIMONCOCHA","4086","2731","6817"
"Sucumbíos",""," PAÑACOCHA","438","422","860"
"Sucumbíos",""," SAN PEDRO DE LOS COFANES","1729","1597","3326"
"Sucumbíos",""," SAN ROQUE","1742","1394","3136"
"Sucumbíos",""," SHUSHUFINDI","14116","12260","26376"
"Sucumbíos",""," SIETE DE JULIO","2044","1769","3813"
"Sucumbíos",""," Total","24155","20173","44328"
"Sucumbíos","SUCUMBIOS                     "," EL PLAYON DE SAN FRANCIS","741","673","1414"
"Sucumbíos",""," LA BONITA","410","401","811"
"Sucumbíos",""," LA SOFIA","60","44","104"
"Sucumbíos",""," ROSA FLORIDA","190","192","382"
"Sucumbíos",""," SANTA BARBARA","369","310","679"
"Sucumbíos",""," Total","1770","1620","3390"
"Sucumbíos","Total","","92848","83624","176472"
"Orellana","AGUARICO                      "," CAPITAN AUGUSTO RIBADENEYRA","350","351","701"
"Orellana",""," CONONACO","269","250","519"
"Orellana",""," NUEVO ROCAFUERTE","527","497","1024"
"Orellana",""," SANTA MARIA DE HUIRIRIMA","390","339","729"
"Orellana",""," TIPUTINI","966","631","1597"
"Orellana",""," YASUNI","150","127","277"
"Orellana",""," Total","2652","2195","4847"
"Orellana","LA JOYA DE LOS SACHAS         "," ENOKANQUI","1222","1140","2362"
"Orellana",""," LA JOYA DE LOS SACHAS","9433","8501","17934"
"Orellana",""," LAGO SAN PEDRO","988","873","1861"
"Orellana",""," POMPEYA","606","598","1204"
"Orellana",""," RUMIPAMBA","1102","891","1993"
"Orellana",""," SAN CARLOS","1539","1307","2846"
"Orellana",""," SAN SEBASTIAN DEL COCA","1742","1611","3353"
"Orellana",""," TRES DE NOVIEMBRE","1677","1461","3138"
"Orellana",""," UNION MILAGREÑA","1607","1293","2900"
"Orellana",""," Total","19916","17675","37591"
"Orellana","LORETO                        "," AVILA","2259","2072","4331"
"Orellana",""," LORETO","2179","2048","4227"
"Orellana",""," PUERTO MURIALDO","1766","1609","3375"
"Orellana",""," SAN JOSE DE DAHUANO","2644","2403","5047"
"Orellana",""," SAN JOSE DE PAYAMINO","1629","1496","3125"
"Orellana",""," SAN VICENTE DE HUATICOCHA","562","496","1058"
"Orellana",""," Total","11039","10124","21163"
"Orellana","ORELLANA                      "," ALEJANDRO LABAKA","647","590","1237"
"Orellana",""," DAYUMA","3524","2774","6298"
"Orellana",""," EL DORADO","872","767","1639"
"Orellana",""," EL EDEN","469","431","900"
"Orellana",""," GARCIA MORENO","594","497","1091"
"Orellana",""," INES ARANGO","1617","1421","3038"
"Orellana",""," LA BELLEZA","2180","1953","4133"
"Orellana",""," NUEVO PARAISO","1538","1179","2717"
"Orellana",""," PUERTO FRANCISCO DE ORELLANA","23598","21565","45163"
"Orellana",""," SAN JOSE DE GUAYUSA","1032","919","1951"
"Orellana",""," SAN LUIS DE ARMENIA","1049","963","2012"
"Orellana",""," TARACOA","1403","1213","2616"
"Orellana",""," Total","38523","34272","72795"
"Orellana","Total","","72130","64266","136396"
"Santo Domingo","SANTO DOMINGO DE LOS TSACHILAS"," ALLURIQUIN","5023","4702","9725"
"Santo Domingo",""," EL ESFUERZO","3020","2743","5763"
"Santo Domingo",""," LUZ DE AMERICA","5690","5191","10881"
"Santo Domingo",""," PUERTO LIMON","4892","4452","9344"
"Santo Domingo",""," SAN JACINTO DEL BUA","6134","5584","11718"
"Santo Domingo",""," SANTA MARIA DEL TOACHI","2991","2624","5615"
"Santo Domingo",""," SANTO DOMINGO DE LOS COLORADOS","150428","155204","305632"
"Santo Domingo",""," VALLE HERMOSO","4880","4455","9335"
"Santo Domingo",""," Total","183058","184955","368013"
"Santo Domingo","Total","","183058","184955","368013"
"Santa Elena","LIBERTAD                      "," LA LIBERTAD","48030","47912","95942"
"Santa Elena",""," Total","48030","47912","95942"
"Santa Elena","SALINAS                       "," ANCONCITO","6116","5706","11822"
"Santa Elena",""," JOSE LUIS TAMAYO","11054","11010","22064"
"Santa Elena",""," SALINAS","18266","16523","34789"
"Santa Elena",""," Total","35436","33239","68675"
"Santa Elena","SANTA ELENA                   "," ATAHUALPA","1689","1843","3532"
"Santa Elena",""," CHANDUY","8337","8026","16363"
"Santa Elena",""," COLONCHE","16158","15164","31322"
"Santa Elena",""," MANGLARALTO","15200","14312","29512"
"Santa Elena",""," SAN JOSE DE ANCON","3439","3438","6877"
"Santa Elena",""," SANTA ELENA","26816","26358","53174"
"Santa Elena",""," SIMON BOLIVAR","1757","1539","3296"
"Santa Elena",""," Total","73396","70680","144076"
"Santa Elena","Total","","156862","151831","308693"
"Zonas No Delimitadas","EL PIEDRERO                   "," EL PIEDRERO","3305","3019","6324"
"Zonas No Delimitadas",""," Total","3305","3019","6324"
"Zonas No Delimitadas","LAS GOLONDRINAS               "," LAS GOLONDRINAS","2768","2534","5302"
"Zonas No Delimitadas",""," Total","2768","2534","5302"
"Zonas No Delimitadas","MANGA DEL CURA                "," MANGA DEL CURA","11083","9675","20758"
"Zonas No Delimitadas",""," Total","11083","9675","20758"
"Zonas No Delimitadas","Total","","17156","15228","32384"
