"Provincia","Nombre del Cantón","Nombre de la Parroquia","Hombre","Mujer","Total"
"Azuay","CAMILO PONCE ENRIQUEZ         "," CAMILO PONCE ENRIQUEZ","9766","7638","17404"
"",""," EL CARMEN DE PIJILI","2445","2149","4594"
"",""," Total","12211","9787","21998"
"","CHORDELEG                     "," CHORDELEG","3241","3546","6787"
"",""," LA UNION","867","1029","1896"
"",""," LUIS GALARZA ORELLANA","661","833","1494"
"",""," PRINCIPAL","597","734","1331"
"",""," SAN MARTIN DE PUZHIO","455","614","1069"
"",""," Total","5821","6756","12577"
"","CUENCA                        "," BAÑOS","7868","8983","16851"
"",""," CHAUCHA","617","680","1297"
"",""," CHECA (JIDCAY)","1182","1559","2741"
"",""," CHIQUINTAD","2251","2575","4826"
"",""," CUENCA","158365","173523","331888"
"",""," CUMBE","2480","3066","5546"
"",""," LLACAO","2487","2855","5342"
"",""," MOLLETURO","3681","3485","7166"
"",""," NULTI","2107","2217","4324"
"",""," OCTAVIO CORDERO PALACIOS","983","1288","2271"
"",""," PACCHA","2961","3506","6467"
"",""," QUINGEO","3421","4029","7450"
"",""," RICAURTE","9247","10114","19361"
"",""," SAN JOAQUIN","3522","3933","7455"
"",""," SANTA ANA","2472","2894","5366"
"",""," SAYAUSI","3943","4449","8392"
"",""," SIDCAY","1743","2221","3964"
"",""," SININCAY","7277","8582","15859"
"",""," TARQUI","4833","5657","10490"
"",""," TURI","4177","4787","8964"
"",""," VALLE","11489","12825","24314"
"",""," VICTORIA DEL PORTETE","2391","2860","5251"
"",""," Total","239497","266088","505585"
"","EL PAN                        "," EL PAN","569","627","1196"
"",""," SAN VICENTE","851","989","1840"
"",""," Total","1420","1616","3036"
"","GIRON                         "," ASUNCION","1429","1622","3051"
"",""," GIRON","3834","4603","8437"
"",""," SAN GERARDO","514","605","1119"
"",""," Total","5777","6830","12607"
"","GUACHAPALA                    "," GUACHAPALA","1560","1849","3409"
"",""," Total","1560","1849","3409"
"","GUALACEO                      "," DANIEL CORDOVA TORAL","722","980","1702"
"",""," GUALACEO","9973","11470","21443"
"",""," JADAN","2042","2284","4326"
"",""," LUIS CORDERO VEGA","902","1128","2030"
"",""," MARIANO MORENO","1181","1435","2616"
"",""," REMIGIO CRESPO TORAL","616","798","1414"
"",""," SAN JUAN","2314","2991","5305"
"",""," SIMON BOLIVAR","515","613","1128"
"",""," ZHIDMAD","1216","1529","2745"
"",""," Total","19481","23228","42709"
"","NABON                         "," COCHAPATA","1410","1662","3072"
"",""," EL PROGRESO","966","1046","2012"
"",""," LAS NIEVES (CHAYA)","605","677","1282"
"",""," NABON","4359","5167","9526"
"",""," Total","7340","8552","15892"
"","OÑA                           "," OÑA","1091","1304","2395"
"",""," SUSUDEL","556","632","1188"
"",""," Total","1647","1936","3583"
"","PAUTE                         "," BULAN","994","1179","2173"
"",""," CHICAN","1694","1950","3644"
"",""," DUG-DUG","860","1043","1903"
"",""," EL CABO","1553","1767","3320"
"",""," GUARAINAG","390","456","846"
"",""," PAUTE","4635","5215","9850"
"",""," SAN CRISTOBAL","1122","1290","2412"
"",""," TOMEBAMBA","633","713","1346"
"",""," Total","11881","13613","25494"
"","PUCARA                        "," PUCARA","3985","4230","8215"
"",""," SAN RAFAEL DE SHARUG","913","924","1837"
"",""," Total","4898","5154","10052"
"","SAN FERNANDO                  "," CHUMBLIN","327","422","749"
"",""," SAN FERNANDO","1417","1827","3244"
"",""," Total","1744","2249","3993"
"","SANTA ISABEL                  "," ABDON CALDERON","2291","2340","4631"
"",""," SANTA ISABEL","5603","6004","11607"
"",""," ZHAGLLI","1016","1139","2155"
"",""," Total","8910","9483","18393"
"","SEVILLA DE ORO                "," AMALUZA","833","590","1423"
"",""," PALMAS","1075","1146","2221"
"",""," SEVILLA DE ORO","1034","1211","2245"
"",""," Total","2942","2947","5889"
"","SIGSIG                        "," CUCHIL","725","963","1688"
"",""," GIMA","1299","1587","2886"
"",""," GUEL","564","784","1348"
"",""," LUDO","1494","1872","3366"
"",""," SAN BARTOLOME","1834","2267","4101"
"",""," SAN JOSE DE RARANGA","1040","1311","2351"
"",""," SIGSIG","4959","6211","11170"
"",""," Total","11915","14995","26910"
"","Total","","337044","375083","712127"
"Bolivar","CALUMA                        "," CALUMA","6509","6620","13129"
"",""," Total","6509","6620","13129"
"","CHILLANES                     "," CHILLANES","6659","6615","13274"
"",""," SAN JOSE DEL TAMBO","2192","1940","4132"
"",""," Total","8851","8555","17406"
"","ECHEANDIA                     "," ECHEANDIA","6149","5965","12114"
"",""," Total","6149","5965","12114"
"","GUARANDA                      "," FACUNDO VELA","1712","1607","3319"
"",""," GUARANDA","26155","29219","55374"
"",""," JULIO E. MORENO","1443","1505","2948"
"",""," SALINAS","2944","2877","5821"
"",""," SAN LORENZO","929","928","1857"
"",""," SAN LUIS DE PAMBIL","2779","2578","5357"
"",""," SAN SIMON (YACOTO)","2048","2155","4203"
"",""," SANTAFE (SANTA FE)","822","930","1752"
"",""," SIMIATUG","5521","5725","11246"
"",""," Total","44353","47524","91877"
"","LAS NAVES                     "," LAS NAVES","3135","2957","6092"
"",""," Total","3135","2957","6092"
"","SAN JOSE DE CHIMBO            "," ASUNCION (ASANCOTO)","1366","1471","2837"
"",""," MAGDALENA (CHAPACOTO)","1349","1470","2819"
"",""," SAN JOSE DE CHIMBO","2734","3075","5809"
"",""," SAN SEBASTIAN","535","522","1057"
"",""," TELIMBELA","1669","1588","3257"
"",""," Total","7653","8126","15779"
"","SAN MIGUEL                    "," BALSAPAMBA","1415","1350","2765"
"",""," BILOVAN","1375","1370","2745"
"",""," REGULO DE MORA","468","476","944"
"",""," SAN MIGUEL","5880","6529","12409"
"",""," SAN PABLO","2640","2849","5489"
"",""," SAN VICENTE","572","571","1143"
"",""," SANTIAGO","875","874","1749"
"",""," Total","13225","14019","27244"
""," Total","","89875","93766","183641"
"Cañar","AZOGUES                       "," AZOGUES","17667","20328","37995"
"",""," COJITAMBO","1594","2095","3689"
"",""," GUAPAN","3933","4920","8853"
"",""," JAVIER LOYOLA","3142","3665","6807"
"",""," LUIS CORDERO","1690","2181","3871"
"",""," PINDILIG","973","1130","2103"
"",""," RIVERA","722","820","1542"
"",""," SAN MIGUEL","1613","1954","3567"
"",""," TADAY","754","883","1637"
"",""," Total","32088","37976","70064"
"","BIBLIAN                       "," BIBLIAN","6106","7599","13705"
"",""," JERUSALEN","761","984","1745"
"",""," NAZON","1106","1459","2565"
"",""," SAN FRANCISCO DE SAGEO","765","966","1731"
"",""," TURUPAMBA","455","616","1071"
"",""," Total","9193","11624","20817"
"","CAÑAR                         "," CAÑAR","8509","9826","18335"
"",""," CHONTAMARCA","1916","2224","4140"
"",""," CHOROCOPTE","1397","1691","3088"
"",""," DUCUR","2077","2076","4153"
"",""," GENERAL MORALES","1609","1791","3400"
"",""," GUALLETURO","1756","2086","3842"
"",""," HONORATO VASQUEZ","2697","3529","6226"
"",""," INGAPIRCA","3683","4657","8340"
"",""," JUNCAL","976","1193","2169"
"",""," SAN ANTONIO","1024","950","1974"
"",""," VENTURA","632","656","1288"
"",""," ZHUD","1094","1274","2368"
"",""," Total","27370","31953","59323"
"","DELEG                         "," DELEG","1878","2555","4433"
"",""," SOLANO","751","916","1667"
"",""," Total","2629","3471","6100"
"","EL TAMBO                      "," EL TAMBO","4364","5111","9475"
"",""," Total","4364","5111","9475"
"","LA TRONCAL                    "," LA TRONCAL","21176","21434","42610"
"",""," MANUEL J. CALLE","1442","1323","2765"
"",""," PANCHO NEGRO","4702","4312","9014"
"",""," Total","27320","27069","54389"
"","SUSCAL                        "," SUSCAL","2271","2745","5016"
"",""," Total","2271","2745","5016"
""," Total","","105235","119949","225184"
"Carchi","BOLIVAR                       "," BOLIVAR","2623","2583","5206"
"",""," GARCIA MORENO","695","711","1406"
"",""," LOS ANDES","1082","1178","2260"
"",""," MONTE OLIVO","889","801","1690"
"",""," SAN RAFAEL","873","868","1741"
"",""," SAN VICENTE DE PUSIR","1004","1040","2044"
"",""," Total","7166","7181","14347"
"","ESPEJO                        "," EL ANGEL","3044","3281","6325"
"",""," EL GOALTAL","436","380","816"
"",""," LA LIBERTAD (ALIZO)","1741","1761","3502"
"",""," SAN ISIDRO","1306","1415","2721"
"",""," Total","6527","6837","13364"
"","","","Hombre","Mujer","Total"
"","MIRA                          "," CONCEPCION","1414","1393","2807"
"",""," JIJON Y CAAMAÑO","1101","970","2071"
"",""," JUAN MONTALVO","671","637","1308"
"",""," MIRA (CHONTAHUASI)","2935","3059","5994"
"",""," Total","6121","6059","12180"
"","MONTUFAR                      "," CHITAN DE NAVARRETE","313","305","618"
"",""," CRISTOBAL COLON","1449","1494","2943"
"",""," FERNANDEZ SALVADOR","663","619","1282"
"",""," LA PAZ","1665","1767","3432"
"",""," PIARTAL","586","554","1140"
"",""," SAN GABRIEL","10234","10862","21096"
"",""," Total","14910","15601","30511"
"","SAN PEDRO DE HUACA            "," HUACA","3163","3078","6241"
"",""," MARISCAL SUCRE","684","699","1383"
"",""," Total","3847","3777","7624"
"","TULCAN                        "," EL CARMELO (EL PUN)","1405","1384","2789"
"",""," EL CHICAL","1756","1681","3437"
"",""," JULIO ANDRADE (OREJUELA)","4876","4758","9634"
"",""," MALDONADO","893","810","1703"
"",""," PIOTER","367","351","718"
"",""," SANTA MARTHA DE CUBA","1196","1170","2366"
"",""," TOBAR DONOSO (LA BOCANA)","473","432","905"
"",""," TUFIÑO","1171","1168","2339"
"",""," TULCAN","29312","31091","60403"
"",""," URBINA (TAYA)","1135","1069","2204"
"",""," Total","42584","43914","86498"
"","Total","","81155","83369","164524"
"Cotopaxi","LA MANA                       "," GUASAGANDA","1997","1911","3908"
"",""," LA MANA","18359","17895","36254"
"",""," PUCAYACU","1064","990","2054"
"",""," Total","21420","20796","42216"
"","LATACUNGA                     "," 11 DE NOVIEMBRE (ILINCHI","944","1044","1988"
"",""," ALAQUES (ALAQUEZ)","2625","2856","5481"
"",""," BELISARIO QUEVEDO","2991","3368","6359"
"",""," GUAITACAMA (GUAYTACAMA)","5128","4540","9668"
"",""," JOSEGUANGO BAJO","1380","1489","2869"
"",""," LATACUNGA","47143","51212","98355"
"",""," MULALO","3870","4225","8095"
"",""," POALO","2732","2977","5709"
"",""," SAN JUAN DE PASTOCALLE","5494","5955","11449"
"",""," TANICUCHI","6256","6575","12831"
"",""," TOACASO","3738","3947","7685"
"",""," Total","82301","88188","170489"
"","PANGUA                        "," EL CORAZON","3267","3298","6565"
"",""," MORASPUNGO","6553","5823","12376"
"",""," PINLLOPATA","530","500","1030"
"",""," RAMON CAMPAÑA","990","1004","1994"
"",""," Total","11340","10625","21965"
"","PUJILI                        "," ANGAMARCA","2480","2769","5249"
"",""," GUANGAJE","3809","4217","8026"
"",""," LA VICTORIA","1438","1578","3016"
"",""," PILALO","1272","1368","2640"
"",""," PUJILI","15732","17698","33430"
"",""," TINGO","2081","1970","4051"
"",""," ZUMBAHUA","5924","6719","12643"
"",""," Total","32736","36319","69055"
"","SALCEDO                       "," ANTONIO JOSE HOLGUIN","1256","1408","2664"
"",""," CUSUBAMBA","3490","3710","7200"
"",""," MULALILLO","2982","3397","6379"
"",""," MULLIQUINDIL (SANTA ANA)","3516","3687","7203"
"",""," PANSALEO","1586","1869","3455"
"",""," SAN MIGUEL","15050","16265","31315"
"",""," Total","27880","30336","58216"
"","SAQUISILI                     "," CANCHAGUA","2614","2841","5455"
"",""," CHANTILIN","453","582","1035"
"",""," COCHAPAMBA","2557","2869","5426"
"",""," SAQUISILI","6333","7071","13404"
"",""," Total","11957","13363","25320"
"","SIGCHOS                       "," CHUGCHILAN","3797","4014","7811"
"",""," ISINLIVI","1625","1602","3227"
"",""," LAS PAMPAS","1024","919","1943"
"",""," PALO QUEMADO","567","463","1030"
"",""," SIGCHOS","3978","3955","7933"
"",""," Total","10991","10953","21944"
"","Total","","198625","210580","409205"
"Chimborazo","ALAUSI                        "," ACHUPALLAS","5004","5525","10529"
"",""," ALAUSI","4935","5275","10210"
"",""," GUASUNTOS","1101","1312","2413"
"",""," HUIGRA","1147","1205","2352"
"",""," MULTITUD","1058","1026","2084"
"",""," PISTISHI (NARIZ DEL DIABLO)","165","180","345"
"",""," PUMALLACTA (PUMAL-LACTA)","412","493","905"
"",""," SEVILLA","370","433","803"
"",""," SIBAMBE","1898","1971","3869"
"",""," TIXAN","5098","5481","10579"
"",""," Total","21188","22901","44089"
"","CHAMBO                        "," CHAMBO","5660","6225","11885"
"",""," Total","5660","6225","11885"
"","CHUNCHI                       "," CAPZOL","426","473","899"
"",""," CHUNCHI","3556","3849","7405"
"",""," COMPUD","423","455","878"
"",""," GONZOL","824","905","1729"
"",""," LLAGOS","833","942","1775"
"",""," Total","6062","6624","12686"
"","COLTA                         "," CAÑI","486","476","962"
"",""," COLUMBE","7776","8086","15862"
"",""," JUAN DE VELASCO (PANGOR)","1926","1992","3918"
"",""," SANTIAGO DE QUITO","2577","3091","5668"
"",""," VILLA LA UNION","8877","9684","18561"
"",""," Total","21642","23329","44971"
"","CUMANDA                       "," CUMANDA","6343","6579","12922"
"",""," Total","6343","6579","12922"
"","GUAMOTE                       "," CEBADAS","4019","4199","8218"
"",""," GUAMOTE","12098","12540","24638"
"",""," PALMIRA","6062","6235","12297"
"",""," Total","22179","22974","45153"
"","GUANO                         "," GUANANDO","183","158","341"
"",""," GUANO","7823","8694","16517"
"",""," ILAPO","810","852","1662"
"",""," LA PROVIDENCIA","267","286","553"
"",""," SAN ANDRES","6477","7004","13481"
"",""," SAN GERARDO DE PACAICAGUAN","1106","1333","2439"
"",""," SAN ISIDRO DE PATULU","2301","2443","4744"
"",""," SAN JOSE DEL CHAZO","495","542","1037"
"",""," SANTA FE DE GALAN","822","851","1673"
"",""," VALPARAISO","211","193","404"
"",""," Total","20495","22356","42851"
"","PALLATANGA                    "," PALLATANGA","5718","5826","11544"
"",""," Total","5718","5826","11544"
"","PENIPE                        "," BILBAO","102","94","196"
"",""," EL ALTAR","631","634","1265"
"",""," LA CANDELARIA","239","236","475"
"",""," MATUS","471","520","991"
"",""," PENIPE","1000","1089","2089"
"",""," PUELA","314","308","622"
"",""," SAN ANTONIO DE BAYUSHIG","517","584","1101"
"",""," Total","3274","3465","6739"
"","RIOBAMBA                      "," CACHA","1410","1750","3160"
"",""," CALPI","3012","3457","6469"
"",""," CUBIJIES","1148","1366","2514"
"",""," FLORES","2074","2472","4546"
"",""," LICAN","3853","4110","7963"
"",""," LICTO","3498","4309","7807"
"",""," PUNGALA","2837","3117","5954"
"",""," PUNIN","2710","3266","5976"
"",""," QUIMIAG","2518","2739","5257"
"",""," RIOBAMBA","74634","82089","156723"
"",""," SAN JUAN","3442","3928","7370"
"",""," SAN LUIS","5704","6298","12002"
"",""," Total","106840","118901","225741"
"","Total","","219401","239180","458581"
"El Oro","ARENILLAS                     "," ARENILLAS","11057","10269","21326"
"",""," CARCABON","391","345","736"
"",""," CHACRAS","818","720","1538"
"",""," PALMALES","1682","1562","3244"
"",""," Total","13948","12896","26844"
"","ATAHUALPA                     "," AYAPAMBA","721","666","1387"
"",""," CERRO AZUL","172","123","295"
"",""," CORDONCILLO","511","492","1003"
"",""," MILAGRO","248","224","472"
"",""," PACCHA","1157","1154","2311"
"",""," SAN JOSE","201","164","365"
"",""," Total","3010","2823","5833"
"","BALSAS                        "," BALSAS","2926","2704","5630"
"",""," BELLAMARIA","632","599","1231"
"",""," Total","3558","3303","6861"
"","CHILLA                        "," CHILLA","1274","1210","2484"
"",""," Total","1274","1210","2484"
"","EL GUABO                      "," BARBONES (SUCRE)","3054","2653","5707"
"",""," EL GUABO","15580","14400","29980"
"",""," LA IBERIA","1883","1826","3709"
"",""," RIO BONITO","2953","2523","5476"
"",""," TENDALES","2916","2221","5137"
"",""," Total","26386","23623","50009"
"","HUAQUILLAS                    "," HUAQUILLAS","24120","24165","48285"
"",""," Total","24120","24165","48285"
"","LAS LAJAS                     "," EL PARAISO","399","362","761"
"",""," LA LIBERTAD","421","381","802"
"",""," LA VICTORIA","1360","1272","2632"
"",""," SAN ISIDRO","309","290","599"
"",""," Total","2489","2305","4794"
"","MACHALA                       "," EL RETIRO","2381","1985","4366"
"",""," MACHALA","120643","120963","241606"
"",""," Total","123024","122948","245972"
"","MARCABELI                     "," EL INGENIO","145","107","252"
"",""," MARCABELI","2636","2562","5198"
"",""," Total","2781","2669","5450"
"","PASAJE                        "," BUENAVISTA","3447","3094","6541"
"",""," CAÑA QUEMADA","972","867","1839"
"",""," CASACAY","1260","1197","2457"
"",""," LA PEAÑA","1825","1776","3601"
"",""," PASAJE","26743","26742","53485"
"",""," PROGRESO","2079","1888","3967"
"",""," UZHCURRUMI","466","450","916"
"",""," Total","36792","36014","72806"
"","PIÑAS                         "," CAPIRO","980","890","1870"
"",""," LA BOCANA","728","637","1365"
"",""," MOROMORO","742","629","1371"
"",""," PIEDRAS","294","275","569"
"",""," PIÑAS","8572","8829","17401"
"",""," SAN ROQUE","463","404","867"
"",""," SARACAY","1366","1179","2545"
"",""," Total","13145","12843","25988"
"","PORTOVELO                     "," CURTINCAPA","277","233","510"
"",""," MORALES","337","330","667"
"",""," PORTOVELO","5176","4820","9996"
"",""," SALATI","535","492","1027"
"",""," Total","6325","5875","12200"
"","SANTA ROSA                    "," BELLAMARIA","1281","1041","2322"
"",""," BELLAVISTA","1421","1414","2835"
"",""," JAMBELI","1084","634","1718"
"",""," LA AVANZADA","1126","942","2068"
"",""," SAN ANTONIO","1089","1001","2090"
"",""," SANTA ROSA","26455","26408","52863"
"",""," TORATA","1038","915","1953"
"",""," VICTORIA","1733","1454","3187"
"",""," Total","35227","33809","69036"
"","ZARUMA                        "," ABAÑIN","842","842","1684"
"",""," ARCAPAMBA","534","461","995"
"",""," GUANAZAN","1478","1567","3045"
"",""," GUIZHAGUIÑA","890","814","1704"
"",""," HUERTAS","1058","938","1996"
"",""," MALVAS","640","545","1185"
"",""," MULUNCAY GRANDE","509","336","845"
"",""," SALVIAS","394","354","748"
"",""," SINSAO","685","651","1336"
"",""," ZARUMA","5253","5306","10559"
"",""," Total","12283","11814","24097"
"","Total","","304362","296297","600659"
"Esmeraldas","ATACAMES                      "," ATACAMES","8525","8330","16855"
"",""," LA UNION","1304","1236","2540"
"",""," SUA","1781","1668","3449"
"",""," TONCHIGUE","4151","3850","8001"
"",""," TONSUPA","5470","5211","10681"
"",""," Total","21231","20295","41526"
"","ELOY ALFARO                   "," ANCHAYACU","1432","1105","2537"
"",""," ATAHUALPA","733","721","1454"
"",""," BORBON","3931","3765","7696"
"",""," COLON ELOY DEL MARIA","736","674","1410"
"",""," LA TOLA","2268","2098","4366"
"",""," LUIS VARGAS TORRES","199","153","352"
"",""," MALDONADO","948","913","1861"
"",""," PAMPANAL DE BOLIVAR","597","521","1118"
"",""," SAN FRANCISCO DE ONZOLE","768","662","1430"
"",""," SAN JOSE DE CAYAPAS","785","728","1513"
"",""," SANTO DOMINGO DE ONZOLE","1055","879","1934"
"",""," SELVA ALEGRE","597","569","1166"
"",""," TELEMBI","2944","2695","5639"
"",""," TIMBIRE","552","485","1037"
"",""," VALDEZ (LIMONES)","3503","2723","6226"
"",""," Total","21048","18691","39739"
"","ESMERALDAS                    "," CAMARONES","1474","1343","2817"
"",""," CHINCA","2369","2183","4552"
"",""," CRNEL. CARLOS CONCHA TORRES","1308","1046","2354"
"",""," ESMERALDAS","77505","84363","161868"
"",""," MAJUA","1373","1161","2534"
"",""," SAN MATEO","3153","2586","5739"
"",""," TABIAZO","1384","1276","2660"
"",""," TACHINA","2014","1969","3983"
"",""," VUELTA LARGA","1496","1501","2997"
"",""," Total","92076","97428","189504"
"","LA CONCORDIA                  "," LA CONCORDIA","21748","21176","42924"
"",""," Total","21748","21176","42924"
"","MUISNE                        "," BOLIVAR","576","463","1039"
"",""," DAULE","1209","944","2153"
"",""," GALERA","970","763","1733"
"",""," MUISNE","4563","4317","8880"
"",""," QUINGUE (OLMEDO PERDOMO","307","267","574"
"",""," SALIMA","599","518","1117"
"",""," SAN FRANCISCO","1523","1286","2809"
"",""," SAN GREGORIO","3207","2708","5915"
"",""," SAN JOSE DE CHAMANGA","2390","1864","4254"
"",""," Total","15344","13130","28474"
"","QUININDE                      "," CHURA (CHANCAMA)","2617","2116","4733"
"",""," CUBE","4108","3482","7590"
"",""," LA UNION","10314","9610","19924"
"",""," MALIMPIA","9621","8151","17772"
"",""," ROSA ZARATE (QUININDE)","34758","32501","67259"
"",""," VICHE","2723","2569","5292"
"",""," Total","64141","58429","122570"
"","RIOVERDE                      "," CHONTADURO","1743","1479","3222"
"",""," CHUMUNDE","1905","1607","3512"
"",""," LAGARTO","3049","2625","5674"
"",""," MONTALVO","2106","1903","4009"
"",""," RIOVERDE","2564","2400","4964"
"",""," ROCAFUERTE","2805","2683","5488"
"",""," Total","14172","12697","26869"
"","SAN LORENZO                   "," 5 DE JUNIO","219","197","416"
"",""," ALTO TAMBO","1001","870","1871"
"",""," ANCON (PICHANGAL)","901","913","1814"
"",""," CALDERON","330","298","628"
"",""," CARONDELET","898","832","1730"
"",""," CONCEPCION","1244","1110","2354"
"",""," MATAJE","786","689","1475"
"",""," SAN JAVIER DE CACHAVI","343","321","664"
"",""," SAN LORENZO","12462","12634","25096"
"",""," SANTA RITA","837","802","1639"
"",""," TAMBILLO","926","817","1743"
"",""," TULULBI","1181","1114","2295"
"",""," URBINA","424","337","761"
"",""," Total","21552","20934","42486"
"","Total","","271312","262780","534092"
"Guayas","ALFREDO BAQUERIZO MORENO      "," ALFREDO BAQUERIZO MORENO","13013","12166","25179"
"",""," Total","13013","12166","25179"
"","BALAO                         "," BALAO","10998","9525","20523"
"",""," Total","10998","9525","20523"
"","BALZAR                        "," BALZAR","28001","25936","53937"
"",""," Total","28001","25936","53937"
"","COLIMES                       "," COLIMES","9147","8160","17307"
"",""," SAN JACINTO","3276","2840","6116"
"",""," Total","12423","11000","23423"
"","CORONEL MARCELINO MARIDUEÑA   "," CORONEL MARCELINO MARIDUEÑA","6265","5768","12033"
"",""," Total","6265","5768","12033"
"","DAULE                         "," DAULE","43372","44136","87508"
"",""," JUAN BAUTISTA AGUIRRE","2825","2677","5502"
"",""," LAUREL","5093","4789","9882"
"",""," LIMONAL","4497","4277","8774"
"",""," LOS LOJAS","4408","4252","8660"
"",""," Total","60195","60131","120326"
"","DURAN                         "," ELOY ALFARO (DURAN)","116401","119368","235769"
"",""," Total","116401","119368","235769"
"","EL EMPALME                    "," EL ROSARIO","4730","4475","9205"
"",""," GUAYAS (PUEBLO NUEVO)","9313","8266","17579"
"",""," VELASCO IBARRA","23981","23686","47667"
"",""," Total","38024","36427","74451"
"","EL TRIUNFO                    "," EL TRIUNFO","22824","21954","44778"
"",""," Total","22824","21954","44778"
"","GENERAL ANTONIO ELIZALDE      "," GENERAL ANTONIO ELIZALDE","5369","5273","10642"
"",""," Total","5369","5273","10642"
"","GUAYAQUIL                     "," GUAYAQUIL","1127137","1164021","2291158"
"",""," JUAN GOMEZ RENDON (PROGR","6134","5763","11897"
"",""," MORRO","2701","2318","5019"
"",""," POSORJA","12269","11867","24136"
"",""," PUNA","3640","3129","6769"
"",""," TENGUEL","6340","5596","11936"
"",""," Total","1158221","1192694","2350915"
"","ISIDRO AYORA                  "," ISIDRO AYORA","5585","5285","10870"
"",""," Total","5585","5285","10870"
"","LOMAS DE SARGENTILLO          "," LOMAS DE SARGENTILLO","9466","8947","18413"
"",""," Total","9466","8947","18413"
"","MILAGRO                       "," CHOBO","2772","2649","5421"
"",""," MARISCAL SUCRE (HUAQUES)","2827","2538","5365"
"",""," MILAGRO","72031","72994","145025"
"",""," ROBERTO ASTUDILLO","5611","5212","10823"
"",""," Total","83241","83393","166634"
"","NARANJAL                      "," JESUS MARIA","3486","2941","6427"
"",""," NARANJAL","20721","19118","39839"
"",""," SAN CARLOS","3530","2986","6516"
"",""," SANTA ROSA DE FLANDES","2917","2527","5444"
"",""," TAURA","5971","4815","10786"
"",""," Total","36625","32387","69012"
"","NARANJITO                     "," NARANJITO","19063","18123","37186"
"",""," Total","19063","18123","37186"
"","NOBOL                         "," NARCISA DE JESUS","9856","9744","19600"
"",""," Total","9856","9744","19600"
"","PALESTINA                     "," PALESTINA","8354","7711","16065"
"",""," Total","8354","7711","16065"
"","PEDRO CARBO                   "," PEDRO CARBO","16216","15101","31317"
"",""," SABANILLA","3635","3254","6889"
"",""," VALLE DE LA VIRGEN","2757","2473","5230"
"",""," Total","22608","20828","43436"
"","PLAYAS                        "," GENERAL VILLAMIL","21242","20693","41935"
"",""," Total","21242","20693","41935"
"","SAMBORONDON                   "," SAMBORONDON","25249","26385","51634"
"",""," TARIFA","8253","7703","15956"
"",""," Total","33502","34088","67590"
"","SANTA LUCIA                   "," SANTA LUCIA","20276","18647","38923"
"",""," Total","20276","18647","38923"
"","SIMON BOLIVAR                 "," CRNEL.LORENZO DE GARAICOA","5729","5169","10898"
"",""," SIMON BOLIVAR","7541","7044","14585"
"",""," Total","13270","12213","25483"
"","URBINA JADO                   "," EL SALITRE (LAS RAMAS)","14399","13718","28117"
"",""," GENERAL VERNAZA","5039","4472","9511"
"",""," JUNQUILLAL","6984","6320","13304"
"",""," LA VICTORIA (ÑAUZA)","3406","3064","6470"
"",""," Total","29828","27574","57402"
"","YAGUACHI                      "," GRAL. PEDRO J. MONTERO","4332","3863","8195"
"",""," VIRGEN DE FATIMA","7289","6900","14189"
"",""," YAGUACHI NUEVO","13429","13188","26617"
"",""," YAGUACHI VIEJO (CONE)","6214","5743","11957"
"",""," Total","31264","29694","60958"
"","Total","","1815914","1829569","3645483"
"Imbabura","ANTONIO ANTE                  "," ATUNTAQUI","11208","12091","23299"
"",""," IMBAYA","652","627","1279"
"",""," SAN FRANCISCO DE NATABUE","2719","2932","5651"
"",""," SAN JOSE DE CHALTURA","1503","1644","3147"
"",""," SAN ROQUE","4987","5155","10142"
"",""," Total","21069","22449","43518"
"","COTACACHI                     "," 6 DE JULIO DE CUELLAJE","936","844","1780"
"",""," APUELA","942","882","1824"
"",""," COTACACHI","8398","8741","17139"
"",""," GARCIA MORENO","2675","2385","5060"
"",""," IMANTAG","2424","2517","4941"
"",""," PEÑAHERRERA","850","794","1644"
"",""," PLAZA GUTIERREZ","260","236","496"
"",""," QUIROGA","3210","3244","6454"
"",""," VACAS GALINDO (EL CHURO)","395","303","698"
"",""," Total","20090","19946","40036"
"","IBARRA                        "," AMBUQUI","2707","2770","5477"
"",""," ANGOCHAGUA","1510","1753","3263"
"",""," CAROLINA","1448","1291","2739"
"",""," IBARRA","67165","72556","139721"
"",""," LA ESPERANZA","3686","3677","7363"
"",""," LITA","1788","1561","3349"
"",""," SALINAS","887","854","1741"
"",""," SAN ANTONIO","8595","8927","17522"
"",""," Total","87786","93389","181175"
"","OTAVALO                       "," DR. MIGUEL EGAS CABEZAS","2344","2539","4883"
"",""," EUGENIO ESPEJO (CALPAQUI)","3499","3858","7357"
"",""," GONZALEZ SUAREZ","2753","2877","5630"
"",""," OTAVALO","25274","27479","52753"
"",""," PATAQUI","128","141","269"
"",""," SAN JOSE DE QUICHINCHE","4142","4334","8476"
"",""," SAN JUAN DE ILUMAN","4186","4398","8584"
"",""," SAN PABLO","4701","5200","9901"
"",""," SAN RAFAEL","2561","2860","5421"
"",""," SELVA ALEGRE","858","742","1600"
"",""," Total","50446","54428","104874"
"","PIMAMPIRO                     "," CHUGA","577","503","1080"
"",""," MARIANO ACOSTA","756","788","1544"
"",""," PIMAMPIRO","4459","4618","9077"
"",""," SAN FRANCISCO DE SIGSIPA","656","613","1269"
"",""," Total","6448","6522","12970"
"","SAN MIGUEL DE URCUQUI         "," CAHUASQUI","936","877","1813"
"",""," LA MERCED DE BUENOS AIRES","989","904","1893"
"",""," PABLO ARENAS","1068","1050","2118"
"",""," SAN BLAS","1468","1547","3015"
"",""," TUMBABIRO","816","811","1627"
"",""," URCUQUI","2548","2657","5205"
"",""," Total","7825","7846","15671"
"","Total"," Total","193664","204580","398244"
"Loja","CALVAS                        "," CARIAMANGA","10402","10899","21301"
"",""," COLAISACA","941","913","1854"
"",""," EL LUCERO","1037","988","2025"
"",""," SANGILLIN","866","802","1668"
"",""," UTUANA","704","633","1337"
"",""," Total","13950","14235","28185"
"","CATAMAYO                      "," CATAMAYO (LA TOMA)","11577","11878","23455"
"",""," EL TAMBO","2375","2255","4630"
"",""," GUAYQUICHUMA","198","185","383"
"",""," SAN PEDRO DE LA BENDITA","780","810","1590"
"",""," ZAMBI","296","284","580"
"",""," Total","15226","15412","30638"
"","CELICA                        "," CELICA","3773","3550","7323"
"",""," CRUZPAMBA","576","518","1094"
"",""," POZUL (SAN JUAN DE POZUL","1520","1515","3035"
"",""," SABANILLA","1318","1125","2443"
"",""," TNTE. MAXIMILIANO RODRIG","319","254","573"
"",""," Total","7506","6962","14468"
"","CHAGUARPAMBA                  "," AMARILLOS","346","317","663"
"",""," BUENAVISTA","627","587","1214"
"",""," CHAGUARPAMBA","1877","1702","3579"
"",""," EL ROSARIO","255","240","495"
"",""," SANTA RUFINA","629","581","1210"
"",""," Total","3734","3427","7161"
"","ESPINDOLA                     "," 27 DE ABRIL","1084","1002","2086"
"",""," AMALUZA","1745","1693","3438"
"",""," BELLAVISTA","1219","1116","2335"
"",""," EL AIRO","536","461","997"
"",""," EL INGENIO","964","907","1871"
"",""," JIMBURA","1169","1147","2316"
"",""," SANTA TERESITA","881","875","1756"
"",""," Total","7598","7201","14799"
"","GONZANAMA                     "," CHANGAIMINA (LA LIBERTAD","1390","1361","2751"
"",""," GONZANAMA","1205","1316","2521"
"",""," NAMBACOLA","2291","2229","4520"
"",""," PURUNUMA (EGUIGUREN)","404","352","756"
"",""," SACAPALCA","1100","1068","2168"
"",""," Total","6390","6326","12716"
"","LOJA                          "," CHANTACO","560","617","1177"
"",""," CHUQUIRIBAMBA","1140","1326","2466"
"",""," EL CISNE","783","845","1628"
"",""," GUALEL","950","1110","2060"
"",""," JIMBILLA","563","551","1114"
"",""," LOJA","86631","93986","180617"
"",""," MALACATOS (VALLADOLID)","3577","3537","7114"
"",""," QUINARA","720","664","1384"
"",""," SAN LUCAS","2210","2463","4673"
"",""," SAN PEDRO DE VILCABAMBA","650","639","1289"
"",""," SANTIAGO","666","707","1373"
"",""," TAQUIL (MIGUEL RIOFRIO)","1819","1844","3663"
"",""," VILCABAMBA (VICTORIA)","2365","2413","4778"
"",""," YANGANA (ARSENIO CASTILLO)","836","683","1519"
"",""," Total","103470","111385","214855"
"","MACARA                        "," LA VICTORIA","799","758","1557"
"",""," LARAMA","564","516","1080"
"",""," MACARA","7959","7771","15730"
"",""," SABIANGO (LA CAPILLA)","327","324","651"
"",""," Total","9649","9369","19018"
"","OLMEDO                        "," LA TINGUE","360","308","668"
"",""," OLMEDO","2062","2140","4202"
"",""," Total","2422","2448","4870"
"","PALTAS                        "," CANGONAMA","636","635","1271"
"",""," CASANGA","931","874","1805"
"",""," CATACOCHA","5943","6259","12202"
"",""," GUACHANAMA","1383","1219","2602"
"",""," LAURO GUERRERO","915","910","1825"
"",""," ORIANGA","890","873","1763"
"",""," SAN ANTONIO","563","528","1091"
"",""," YAMANA","620","622","1242"
"",""," Total","11881","11920","23801"
"","PINDAL                        "," 12 DE DICIEMBRE","989","902","1891"
"",""," CHAQUINAL","583","506","1089"
"",""," PINDAL","2930","2735","5665"
"",""," Total","4502","4143","8645"
"","PUYANGO                       "," ALAMOR","4119","4177","8296"
"",""," CIANO","721","705","1426"
"",""," EL ARENAL","511","470","981"
"",""," EL LIMO (MARIANA DE JESUS)","1290","1080","2370"
"",""," MERCADILLO","599","575","1174"
"",""," VICENTINO","646","620","1266"
"",""," Total","7886","7627","15513"
"","QUILANGA                      "," FUNDOCHAMBA","190","163","353"
"",""," QUILANGA","1386","1335","2721"
"",""," SAN ANTONIO DE LAS ARADAS","645","618","1263"
"",""," Total","2221","2116","4337"
"","SARAGURO                      "," EL PARAISO DE CELEN","1256","1501","2757"
"",""," EL TABLON","437","480","917"
"",""," LLUZHAPA","834","871","1705"
"",""," MANU","1255","1413","2668"
"",""," SAN ANTONIO DE QUMBE","530","616","1146"
"",""," SAN PABLO DE TENTA","1747","1929","3676"
"",""," SAN SEBASTIAN DE YULUC","479","503","982"
"",""," SARAGURO","4228","4817","9045"
"",""," SELVA ALEGRE","903","1024","1927"
"",""," SUMAYPAMBA","769","825","1594"
"",""," URDANETA (PAQUISHAPA)","1685","2081","3766"
"",""," Total","14123","16060","30183"
"","SOZORANGA                     "," NUEVA FATIMA","466","437","903"
"",""," SOZORANGA","1974","1787","3761"
"",""," TACAMOROS","1355","1446","2801"
"",""," Total","3795","3670","7465"
"","ZAPOTILLO                     "," BOLASPAMBA","594","492","1086"
"",""," CAZADEROS","638","534","1172"
"",""," GARZAREAL","962","820","1782"
"",""," LIMONES","747","663","1410"
"",""," PALETILLAS","1379","1252","2631"
"",""," ZAPOTILLO","2121","2110","4231"
"",""," Total","6441","5871","12312"
"","Total","","220794","228172","448966"
"Los Rios","BABA                          "," BABA","9845","8998","18843"
"",""," GUARE","6067","5380","11447"
"",""," ISLA DE BEJUCAL","4853","4538","9391"
"",""," Total","20765","18916","39681"
"","BABAHOYO                      "," BABAHOYO","48220","48736","96956"
"",""," CARACOL","2688","2424","5112"
"",""," FEBRES CORDERO (LAS JUNTAS)","9442","8543","17985"
"",""," LA UNION","6635","6062","12697"
"",""," PIMOCHA","10982","10044","21026"
"",""," Total","77967","75809","153776"
"","BUENA FE                      "," PATRICIA PILAR","6441","5837","12278"
"",""," SAN JACINTO DE BUENA FE","26208","24662","50870"
"",""," Total","32649","30499","63148"
"","MOCACHE                       "," MOCACHE","19996","18396","38392"
"",""," Total","19996","18396","38392"
"","MONTALVO                      "," MONTALVO","12298","11866","24164"
"",""," Total","12298","11866","24164"
"","PALENQUE                      "," PALENQUE","11841","10479","22320"
"",""," Total","11841","10479","22320"
"","PUEBLOVIEJO                   "," PUEBLOVIEJO","6828","6548","13376"
"",""," PUERTO PECHICHE","2412","2262","4674"
"",""," SAN JUAN","9374","9053","18427"
"",""," Total","18614","17863","36477"
"","QUEVEDO                       "," LA ESPERANZA","2509","2344","4853"
"",""," QUEVEDO","79218","79476","158694"
"",""," SAN CARLOS","5094","4934","10028"
"",""," Total","86821","86754","173575"
"","QUINSALOMA                    "," QUINSALOMA","8627","7849","16476"
"",""," Total","8627","7849","16476"
"","URDANETA                      "," CATARAMA","4305","4286","8591"
"",""," RICAURTE","10758","9914","20672"
"",""," Total","15063","14200","29263"
"","VALENCIA                      "," VALENCIA","22592","19964","42556"
"",""," Total","22592","19964","42556"
"","VENTANAS                      "," VENTANAS","22916","22735","45651"
"",""," ZAPOTAL","10869","10031","20900"
"",""," Total","33785","32766","66551"
"","VINCES                        "," ANTONIO SOTOMAYOR","8673","7620","16293"
"",""," VINCES","28408","27035","55443"
"",""," Total","37081","34655","71736"
"","Total","","398099","380016","778115"
"Manabi","24 DE MAYO                    "," ARQ. SIXTO DURAN BALLEN","2091","1861","3952"
"",""," BELLAVISTA","2512","2408","4920"
"",""," NOBOA","3440","3108","6548"
"",""," SUCRE","6858","6568","13426"
"",""," Total","14901","13945","28846"
"","BOLIVAR                       "," CALCETA","16660","16755","33415"
"",""," MEMBRILLO","1849","1704","3553"
"",""," QUIROGA","2305","1462","3767"
"",""," Total","20814","19921","40735"
"","CHONE                         "," BOYACA","2377","2124","4501"
"",""," CANUTO","5212","5143","10355"
"",""," CHIBUNGA","3455","2905","6360"
"",""," CHONE","36669","38237","74906"
"",""," CONVENTO","3424","3154","6578"
"",""," ELOY ALFARO","4036","3796","7832"
"",""," RICAURTE","4047","3873","7920"
"",""," SAN ANTONIO","4063","3976","8039"
"",""," Total","63283","63208","126491"
"","EL CARMEN                     "," EL CARMEN","39567","38176","77743"
"",""," SAN PEDRO DE SUMA","3521","3171","6692"
"",""," WILFRIDO LOOR MOREIRA","2429","2157","4586"
"",""," Total","45517","43504","89021"
"","FLAVIO ALFARO                 "," FLAVIO ALFARO","9500","9036","18536"
"",""," SAN FRANCISCO DE NOVILLO","1502","1277","2779"
"",""," ZAPALLO","1907","1782","3689"
"",""," Total","12909","12095","25004"
"","JAMA                          "," JAMA","11850","11403","23253"
"",""," Total","11850","11403","23253"
"","JARAMIJO                      "," JARAMIJO","9511","8975","18486"
"",""," Total","9511","8975","18486"
"","JIPIJAPA                      "," AMERICA","1638","1422","3060"
"",""," EL ANEGADO","3656","3208","6864"
"",""," JIPIJAPA","24301","24775","49076"
"",""," JULCUY","1150","1025","2175"
"",""," LA UNION","1062","879","1941"
"",""," MEMBRILLAL","560","445","1005"
"",""," PEDRO PABLO GOMEZ","1897","1667","3564"
"",""," PUERTO DE CAYO","1807","1591","3398"
"",""," Total","36071","35012","71083"
"","JUNIN                         "," JUNIN","9750","9192","18942"
"",""," Total","9750","9192","18942"
"","MANTA                         "," MANTA","108677","112445","221122"
"",""," SAN LORENZO","1374","1273","2647"
"",""," SANTA MARIANITA","1352","1356","2708"
"",""," Total","111403","115074","226477"
"","MONTECRISTI                   "," LA PILA","1286","1166","2452"
"",""," MONTECRISTI","34018","33824","67842"
"",""," Total","35304","34990","70294"
"","OLMEDO                        "," OLMEDO","5083","4761","9844"
"",""," Total","5083","4761","9844"
"","PAJAN                         "," CAMPOZANO","4530","3977","8507"
"",""," CASCOL","3917","3275","7192"
"",""," GUALE","2043","1888","3931"
"",""," LASCANO","2732","2445","5177"
"",""," PAJAN","6307","5959","12266"
"",""," Total","19529","17544","37073"
"","PEDERNALES                    "," 10 DE AGOSTO","2680","2532","5212"
"",""," ATAHUALPA","1310","1258","2568"
"",""," COJIMIES","7241","6467","13708"
"",""," PEDERNALES","17189","16451","33640"
"",""," Total","28420","26708","55128"
"","PICHINCHA                     "," BARRAGANETE","4010","3557","7567"
"",""," PICHINCHA","9000","8416","17416"
"",""," SAN SEBASTIAN","2663","2598","5261"
"",""," Total","15673","14571","30244"
"","PORTOVIEJO                    "," ABDON CALDERON","7204","6960","14164"
"",""," ALHAJUELA (BAJO GRANDE)","1844","1910","3754"
"",""," CHIRIJOS","1204","1158","2362"
"",""," CRUCITA","7184","6866","14050"
"",""," PORTOVIEJO","108878","114208","223086"
"",""," PUEBLO NUEVO","1645","1524","3169"
"",""," RIOCHICO (RIO CHICO)","6155","5602","11757"
"",""," SAN PLACIDO","3855","3832","7687"
"",""," Total","137969","142060","280029"
"","PUERTO LOPEZ                  "," MACHALILLA","2568","2421","4989"
"",""," PUERTO LOPEZ","5647","5281","10928"
"",""," SALANGO","2349","2185","4534"
"",""," Total","10564","9887","20451"
"","ROCAFUERTE                    "," ROCAFUERTE","16922","16547","33469"
"",""," Total","16922","16547","33469"
"","SAN VICENTE                   "," CANOA","3663","3224","6887"
"",""," SAN VICENTE","7601","7537","15138"
"",""," Total","11264","10761","22025"
"","SANTA ANA                     "," AYACUCHO","3729","3694","7423"
"",""," HONORATO VASQUEZ","2994","2892","5886"
"",""," LA UNION","3354","3112","6466"
"",""," SAN PABLO","2802","2510","5312"
"",""," SANTA ANA DE VUELTA LARGA","11214","11084","22298"
"",""," Total","24093","23292","47385"
"","SUCRE                         "," BAHIA DE CARAQUEZ","13075","13037","26112"
"",""," CHARAPOTO","10216","9844","20060"
"",""," SAN ISIDRO","5651","5336","10987"
"",""," Total","28942","28217","57159"
"","TOSAGUA                       "," ANGEL PEDRO GILER","3212","3070","6282"
"",""," BACHILLERO","1979","1906","3885"
"",""," TOSAGUA","14336","13838","28174"
"",""," Total","19527","18814","38341"
"","Total"," Total","689299","680481","1369780"
"Morona Santiago","GUALAQUIZA                    "," AMAZONAS (ROSARIO DE CUYES)","201","211","412"
"",""," BERMEJOS","119","104","223"
"",""," BOMBOIZA","2341","2282","4623"
"",""," CHIGUINDA","266","286","552"
"",""," EL IDEAL","425","396","821"
"",""," EL ROSARIO","303","305","608"
"",""," GUALAQUIZA","4694","4534","9228"
"",""," NUEVA TARQUI","252","259","511"
"",""," SAN MIGUEL DE CUYES","96","88","184"
"",""," Total","8697","8465","17162"
"","HUAMBOYA                      "," CHIGUAZA","3000","2928","5928"
"",""," HUAMBOYA","1316","1222","2538"
"",""," Total","4316","4150","8466"
"","LIMON INDANZA                 "," GENERAL LEONIDAS PLAZA G.","1920","2061","3981"
"",""," INDANZA","704","659","1363"
"",""," SAN ANTONIO","1073","1084","2157"
"",""," SAN MIGUEL DE CONCHAY","207","198","405"
"",""," SANTA SUSANA DE CHIVIAZA","386","386","772"
"",""," YUNGANZA","522","522","1044"
"",""," Total","4812","4910","9722"
"","LOGROÑO                       "," LOGROÑO","1054","999","2053"
"",""," SHIMPIS","960","933","1893"
"",""," YAUPI","859","918","1777"
"",""," Total","2873","2850","5723"
"","MORONA                        "," ALSHI","238","187","425"
"",""," CUCHAENTZA","909","876","1785"
"",""," GENERAL PROAÑO","1276","1314","2590"
"",""," MACAS","9637","9539","19176"
"",""," RIO BLANCO","982","1010","1992"
"",""," SAN ISIDRO","387","398","785"
"",""," SEVILLA DON BOSCO","6686","6727","13413"
"",""," SINAI","383","383","766"
"",""," ZUÑA (ZUÑAC)","113","110","223"
"",""," Total","20611","20544","41155"
"","PABLO VI                      "," PABLO VI","941","882","1823"
"",""," Total","941","882","1823"
"","PALORA                        "," 16 DE AGOSTO","517","473","990"
"",""," ARAPICOS","258","224","482"
"",""," CUMANDA","187","158","345"
"",""," PALORA (METZERA)","1975","1972","3947"
"",""," SANGAY","609","563","1172"
"",""," Total","3546","3390","6936"
"","SAN JUAN BOSCO                "," PAN DE AZUCAR","142","123","265"
"",""," SAN CARLOS DE LIMON","412","381","793"
"",""," SAN JACINTO DE WAKAMBEIS","105","99","204"
"",""," SAN JUAN BOSCO","1071","1106","2177"
"",""," SANTIAGO DE PANANZA","245","224","469"
"",""," Total","1975","1933","3908"
"","SANTIAGO                      "," CHUPIANZA","248","219","467"
"",""," COPAL","274","206","480"
"",""," PATUCA","1198","935","2133"
"",""," SAN FRANCISCO DE CHINIMB","521","558","1079"
"",""," SAN LUIS DE EL ACHO","313","305","618"
"",""," SANTIAGO","804","706","1510"
"",""," SANTIAGO DE MENDEZ","1501","1507","3008"
"",""," Total","4859","4436","9295"
"","SUCUA                         "," ASUNCION","925","978","1903"
"",""," HUAMBI","1429","1462","2891"
"",""," SANTA MARIANITA DE JESUS","444","461","905"
"",""," SUCUA","6174","6445","12619"
"",""," Total","8972","9346","18318"
"","TAISHA                        "," HUASAGA","730","779","1509"
"",""," MACUMA","1943","1942","3885"
"",""," PUMPUENTSA","1231","1222","2453"
"",""," TAISHA","3126","2823","5949"
"",""," TUTINENTZA","2338","2303","4641"
"",""," Total","9368","9069","18437"
"","TIWINTZA                      "," SAN JOSE DE MORONA","1210","1064","2274"
"",""," TIWINTZA","2669","2052","4721"
"",""," Total","3879","3116","6995"
"","Total","","74849","73091","147940"
"Napo","ARCHIDONA                     "," ARCHIDONA","5821","5868","11689"
"",""," COTUNDO","4252","4124","8376"
"",""," SAN PABLO DE USHPAYACU","2560","2344","4904"
"",""," Total","12633","12336","24969"
"","CARLOS JULIO AROSEMENA        "," CARLOS JULIO AROSEMENA TOLA","1934","1730","3664"
"",""," Total","1934","1730","3664"
"","EL CHACO                      "," EL CHACO","2430","2386","4816"
"",""," GONZALO DIAZ DE PINEDA","299","236","535"
"",""," LINARES","113","96","209"
"",""," OYACACHI","315","305","620"
"",""," SANTA ROSA","685","558","1243"
"",""," SARDINAS","286","251","537"
"",""," Total","4128","3832","7960"
"","QUIJOS                        "," BAEZA","970","976","1946"
"",""," COSANGA","288","217","505"
"",""," CUYUJA","315","299","614"
"",""," PAPALLACTA","492","428","920"
"",""," SAN FRANCISCO DE BORJA","1052","1148","2200"
"",""," SUMACO","19","20","39"
"",""," Total","3136","3088","6224"
"","TENA                          "," AHUANO","2873","2706","5579"
"",""," CHONTAPUNTA","3559","3128","6687"
"",""," PANO","694","698","1392"
"",""," PUERTO MISAHUALLI","2668","2459","5127"
"",""," PUERTO NAPO","2796","2597","5393"
"",""," TALAG","1431","1337","2768"
"",""," TENA","16922","17012","33934"
"",""," Total","30943","29937","60880"
"","Total","","52774","50923","103697"
"Pastaza","ARAJUNO                       "," ARAJUNO","1979","1827","3806"
"",""," CURARAY","1423","1262","2685"
"",""," Total","3402","3089","6491"
"","MERA                          "," MADRE TIERRA","794","794","1588"
"",""," MERA","754","767","1521"
"",""," SHELL","4531","4221","8752"
"",""," Total","6079","5782","11861"
"","PASTAZA                       "," CANELOS","1096","1077","2173"
"",""," DIEZ DE AGOSTO","606","538","1144"
"",""," EL TRIUNFO","685","640","1325"
"",""," FATIMA","447","416","863"
"",""," MONTALVO (ANDOAS)","2019","1830","3849"
"",""," POMONA","131","106","237"
"",""," PUYO","17979","18680","36659"
"",""," RIO CORRIENTES","111","124","235"
"",""," RIO TIGRE","339","317","656"
"",""," SARAYACU","1271","1285","2556"
"",""," SIMON BOLIVAR","2817","2865","5682"
"",""," TARQUI","1963","1868","3831"
"",""," TENIENTE HUGO ORTIZ","553","495","1048"
"",""," VERACRUZ (INDILLAMA)","906","852","1758"
"",""," Total","30923","31093","62016"
"","SANTA CLARA                   "," SAN JOSE","386","349","735"
"",""," SANTA CLARA","1470","1360","2830"
"",""," Total","1856","1709","3565"
"","Total","","42260","41673","83933"
"Pichincha","CAYAMBE                       "," ASCAZUBI","2499","2551","5050"
"",""," CANGAHUA","7920","8311","16231"
"",""," CAYAMBE","24989","25840","50829"
"",""," OLMEDO (PESILLO)","3162","3610","6772"
"",""," OTON","1357","1409","2766"
"",""," SANTA ROSA DE CUZUBAMBA","2040","2107","4147"
"",""," Total","41967","43828","85795"
"","MEJIA                         "," ALOAG","4509","4728","9237"
"",""," ALOASI","4635","5051","9686"
"",""," CUTUGLAHUA","8220","8526","16746"
"",""," EL CHAUPI","710","746","1456"
"",""," MACHACHI","13438","14185","27623"
"",""," MANUEL CORNEJO ASTORGA","1944","1717","3661"
"",""," TAMBILLO","4068","4251","8319"
"",""," UYUMBICHO","2259","2348","4607"
"",""," Total","39783","41552","81335"
"","PEDRO MONCAYO                 "," LA ESPERANZA","1943","2043","3986"
"",""," MALCHINGUI","2280","2344","4624"
"",""," TABACUNDO","8163","8240","16403"
"",""," TOCACHI","997","988","1985"
"",""," TUPIGACHI","2928","3246","6174"
"",""," Total","16311","16861","33172"
"","PEDRO VICENTE MALDONADO       "," PEDRO VICENTE MALDONADO","6735","6189","12924"
"",""," Total","6735","6189","12924"
"","PUERTO QUITO                  "," PUERTO QUITO","10774","9671","20445"
"",""," Total","10774","9671","20445"
"","QUITO                         "," ALANGASI","11851","12400","24251"
"",""," AMAGUAÑA","15395","15711","31106"
"",""," ATAHUALPA (HABASPAMBA)","947","954","1901"
"",""," CALACALI","1947","1948","3895"
"",""," CALDERON (CARAPUNGO)","74682","77560","152242"
"",""," CHAVEZPAMBA","403","398","801"
"",""," CHECA (CHILPA)","4532","4448","8980"
"",""," CONOCOTO","39691","42381","82072"
"",""," CUMBAYA","15248","16215","31463"
"",""," EL QUINCHE","8015","8041","16056"
"",""," GUALEA","1073","952","2025"
"",""," GUANGOPOLO","1528","1531","3059"
"",""," GUAYLLABAMBA","8199","8014","16213"
"",""," LA MERCED","4122","4272","8394"
"",""," LLANO CHICO","5205","5468","10673"
"",""," LLOA","784","710","1494"
"",""," NANEGAL","1417","1219","2636"
"",""," NANEGALITO","1555","1471","3026"
"",""," NAYON","7628","8007","15635"
"",""," NONO","910","822","1732"
"",""," PACTO","2543","2255","4798"
"",""," PERUCHO","407","382","789"
"",""," PIFO","8235","8410","16645"
"",""," PINTAG","8815","9115","17930"
"",""," POMASQUI","14101","14809","28910"
"",""," PUELLARO","2772","2716","5488"
"",""," PUEMBO","6809","6784","13593"
"",""," QUITO","783616","835530","1619146"
"",""," SAN ANTONIO","15912","16445","32357"
"",""," SAN JOSE DE MINAS","3775","3468","7243"
"",""," TABABELA","1400","1423","2823"
"",""," TUMBACO","24448","25496","49944"
"",""," YARUQUI","8877","8977","17854"
"",""," ZAMBIZA","1969","2048","4017"
"",""," Total","1088811","1150380","2239191"
"","RUMIÑAHUI                     "," COTOGCHOA","1949","1988","3937"
"",""," RUMIPAMBA","399","376","775"
"",""," SANGOLQUI","39569","41571","81140"
"",""," Total","41917","43935","85852"
"","SAN MIGUEL DE LOS BANCOS      "," MINDO","1991","1851","3842"
"",""," SAN MIGUEL DE LOS BANCOS","7422","6309","13731"
"",""," Total","9413","8160","17573"
"","Total","","1255711","1320576","2576287"
"Tungurahua","AMBATO                        "," AMBATILLO","2598","2645","5243"
"",""," AMBATO","86299","92239","178538"
"",""," ATAHUALPA (CHISALATA)","4998","5263","10261"
"",""," AUGUSTO N. MARTINEZ","3962","4229","8191"
"",""," CONSTANTINO FERNANDEZ","1255","1279","2534"
"",""," CUNCHIBAMBA","2107","2368","4475"
"",""," HUACHI GRANDE","5187","5427","10614"
"",""," IZAMBA","7111","7452","14563"
"",""," JUAN BENIGNO VELA","3587","3869","7456"
"",""," MONTALVO","1961","1951","3912"
"",""," PASA","3220","3279","6499"
"",""," PICAIGUA","4022","4261","8283"
"",""," PILAGUIN (PILAHUIN)","5868","6260","12128"
"",""," QUISAPINCHA (QUIZAPINCHA)","6235","6766","13001"
"",""," SAN BARTOLOME DE PINLLOG","4437","4657","9094"
"",""," SAN FERNANDO","1176","1315","2491"
"",""," SANTA ROSA","10163","10840","21003"
"",""," TOTORAS","3394","3504","6898"
"",""," UNAMUNCHO","2250","2422","4672"
"",""," Total","159830","170026","329856"
"","BAÑOS                         "," BAÑOS","7318","7335","14653"
"",""," LLIGUA","138","142","280"
"",""," RIO NEGRO","638","608","1246"
"",""," RIO VERDE","669","638","1307"
"",""," ULBA","1271","1261","2532"
"",""," Total","10034","9984","20018"
"","CEVALLOS                      "," CEVALLOS","4028","4135","8163"
"",""," Total","4028","4135","8163"
"","MOCHA                         "," MOCHA","2698","2806","5504"
"",""," PINGUILI","658","615","1273"
"",""," Total","3356","3421","6777"
"","PATATE                        "," EL TRIUNFO","810","773","1583"
"",""," LOS ANDES","697","694","1391"
"",""," PATATE","4068","4086","8154"
"",""," SUCRE","1145","1224","2369"
"",""," Total","6720","6777","13497"
"","QUERO                         "," QUERO","7027","7227","14254"
"",""," RUMIPAMBA","1460","1513","2973"
"",""," YANAYACU - MOCHAPATA","1002","976","1978"
"",""," Total","9489","9716","19205"
"","SAN PEDRO DE PELILEO          "," BENITEZ (PACHANLICA)","1082","1101","2183"
"",""," BOLIVAR","1316","1397","2713"
"",""," CHIQUICHA","1163","1282","2445"
"",""," COTALO","944","908","1852"
"",""," EL ROSARIO (RUMICHACA)","1269","1369","2638"
"",""," GARCIA MORENO (CHUMAQUI)","3056","3324","6380"
"",""," GUAMBALO (HUAMBALO)","3883","3979","7862"
"",""," PELILEO","11830","12784","24614"
"",""," SALASACA","2784","3102","5886"
"",""," Total","27327","29246","56573"
"","SANTIAGO DE PILLARO           "," BAQUERIZO MORENO","132","145","277"
"",""," EMILIO MARIA TERAN","733","771","1504"
"",""," MARCOS ESPINEL (CHACATA)","1100","1234","2334"
"",""," PILLARO","6313","7070","13383"
"",""," PRESIDENTE URBINA","1290","1510","2800"
"",""," SAN ANDRES","5248","5952","11200"
"",""," SAN JOSE DE POALO","915","965","1880"
"",""," SAN MIGUELITO","2360","2619","4979"
"",""," Total","18091","20266","38357"
"","TISALEO                       "," QUINCHICOTO","633","673","1306"
"",""," TISALEO","5275","5556","10831"
"",""," Total","5908","6229","12137"
"","Total"," Total","244783","259800","504583"
"Zamora Chinchipe","CENTINELA DEL CONDOR          "," ZUMBI","3381","3098","6479"
"",""," Total","3381","3098","6479"
"","CHINCHIPE                     "," CHITO","663","567","1230"
"",""," EL CHORRO","126","90","216"
"",""," LA CHONTA","141","120","261"
"",""," PUCAPAMBA","81","37","118"
"",""," SAN ANDRES","241","175","416"
"",""," ZUMBA","3681","3197","6878"
"",""," Total","4933","4186","9119"
"","EL PANGUI                     "," EL GUISMI","798","806","1604"
"",""," EL PANGUI","2492","2496","4988"
"",""," PACHICUTZA","654","636","1290"
"",""," TUNDAYME","394","343","737"
"",""," Total","4338","4281","8619"
"","NANGARITZA                    "," GUAYZIMI","1337","1261","2598"
"",""," NUEVO PARAISO","312","282","594"
"",""," ZURMI","1039","965","2004"
"",""," Total","2688","2508","5196"
"","PALANDA                       "," EL PORVENIR DEL CARMEN","793","691","1484"
"",""," LA CANELA","192","163","355"
"",""," PALANDA","1903","1798","3701"
"",""," SAN FRANCISCO DE VERGEL","690","628","1318"
"",""," VALLADOLID","668","563","1231"
"",""," Total","4246","3843","8089"
"","PAQUISHA                      "," BELLAVISTA","149","152","301"
"",""," NUEVO QUITO","1258","843","2101"
"",""," PAQUISHA","750","702","1452"
"",""," Total","2157","1697","3854"
"","YACUAMBI                      "," 28 DE MAYO","1587","1566","3153"
"",""," LA PAZ","1029","1014","2043"
"",""," TUTUPALI","322","317","639"
"",""," Total","2938","2897","5835"
"","YANTZAZA                      "," CHICAÑA","1330","1331","2661"
"",""," LOS ENCUENTROS","1940","1718","3658"
"",""," YANZATZA","6186","6170","12356"
"",""," Total","9456","9219","18675"
"","ZAMORA                        "," CUMBARATZA","2259","2157","4416"
"",""," GUADALUPE","1412","1445","2857"
"",""," IMBANA","567","559","1126"
"",""," SABANILLA","301","283","584"
"",""," SAN CARLOS DE LAS MINAS","1280","900","2180"
"",""," TIMBARA","494","466","960"
"",""," ZAMORA","7002","6385","13387"
"",""," Total","13315","12195","25510"
"","Total","","47452","43924","91376"
"Galápagos","ISABELA                       "," PUERTO VILLAMIL","1105","987","2092"
"",""," TOMAS DE BERLANGA","97","67","164"
"",""," Total","1202","1054","2256"
"","SAN CRISTOBAL                 "," EL PROGRESO","401","257","658"
"",""," ISLA SANTA MARIA (FLOREANA)","88","57","145"
"",""," PUERTO BAQUERIZO MORENO","3498","3174","6672"
"",""," Total","3987","3488","7475"
"","SANTA CRUZ                    "," BELLAVISTA","1251","1174","2425"
"",""," PUERTO AYORA","6064","5910","11974"
"",""," SANTA ROSA","517","477","994"
"",""," Total","7832","7561","15393"
"","Total","","13021","12103","25124"
"Sucumbíos","CASCALES                      "," EL DORADO DE CASCALES","3955","3619","7574"
"",""," SANTA ROSA DE SUCUMBIOS","442","339","781"
"",""," SEVILLA","1410","1339","2749"
"",""," Total","5807","5297","11104"
"","CUYABENO                      "," AGUAS NEGRAS","771","692","1463"
"",""," CUYABENO","219","173","392"
"",""," TARAPOA","3042","2236","5278"
"",""," Total","4032","3101","7133"
"","GONZALO PIZARRO               "," EL REVENTADOR","802","699","1501"
"",""," GONZALO PIZARRO","1503","1452","2955"
"",""," LUMBAQUI","1724","1501","3225"
"",""," PUERTO LIBRE","494","424","918"
"",""," Total","4523","4076","8599"
"","LAGO AGRIO                    "," DURENO","1431","1325","2756"
"",""," EL ENO","3424","3212","6636"
"",""," GENERAL FARFAN","3691","3078","6769"
"",""," JAMBELI","1772","1543","3315"
"",""," NUEVA LOJA","29017","28710","57727"
"",""," PACAYACU","4440","3809","8249"
"",""," STA. CECILIA","3191","3101","6292"
"",""," Total","46966","44778","91744"
"","PUTUMAYO                      "," PALMA ROJA","2132","1822","3954"
"",""," PUERTO BOLIVAR","240","39","279"
"",""," PUERTO EL CARMEN DEL PUTUMAYO","1818","1633","3451"
"",""," PUERTO RODRIGUEZ","312","184","496"
"",""," SANTA ELENA","1093","901","1994"
"",""," Total","5595","4579","10174"
"","SHUSHUFINDI                   "," LIMONCOCHA","4086","2731","6817"
"",""," PAÑACOCHA","438","422","860"
"",""," SAN PEDRO DE LOS COFANES","1729","1597","3326"
"",""," SAN ROQUE","1742","1394","3136"
"",""," SHUSHUFINDI","14116","12260","26376"
"",""," SIETE DE JULIO","2044","1769","3813"
"",""," Total","24155","20173","44328"
"","SUCUMBIOS                     "," EL PLAYON DE SAN FRANCIS","741","673","1414"
"",""," LA BONITA","410","401","811"
"",""," LA SOFIA","60","44","104"
"",""," ROSA FLORIDA","190","192","382"
"",""," SANTA BARBARA","369","310","679"
"",""," Total","1770","1620","3390"
"","Total","","92848","83624","176472"
"Orellana","AGUARICO                      "," CAPITAN AUGUSTO RIBADENEYRA","350","351","701"
"",""," CONONACO","269","250","519"
"",""," NUEVO ROCAFUERTE","527","497","1024"
"",""," SANTA MARIA DE HUIRIRIMA","390","339","729"
"",""," TIPUTINI","966","631","1597"
"",""," YASUNI","150","127","277"
"",""," Total","2652","2195","4847"
"","LA JOYA DE LOS SACHAS         "," ENOKANQUI","1222","1140","2362"
"",""," LA JOYA DE LOS SACHAS","9433","8501","17934"
"",""," LAGO SAN PEDRO","988","873","1861"
"",""," POMPEYA","606","598","1204"
"",""," RUMIPAMBA","1102","891","1993"
"",""," SAN CARLOS","1539","1307","2846"
"",""," SAN SEBASTIAN DEL COCA","1742","1611","3353"
"",""," TRES DE NOVIEMBRE","1677","1461","3138"
"",""," UNION MILAGREÑA","1607","1293","2900"
"",""," Total","19916","17675","37591"
"","LORETO                        "," AVILA","2259","2072","4331"
"",""," LORETO","2179","2048","4227"
"",""," PUERTO MURIALDO","1766","1609","3375"
"",""," SAN JOSE DE DAHUANO","2644","2403","5047"
"",""," SAN JOSE DE PAYAMINO","1629","1496","3125"
"",""," SAN VICENTE DE HUATICOCHA","562","496","1058"
"",""," Total","11039","10124","21163"
"","ORELLANA                      "," ALEJANDRO LABAKA","647","590","1237"
"",""," DAYUMA","3524","2774","6298"
"",""," EL DORADO","872","767","1639"
"",""," EL EDEN","469","431","900"
"",""," GARCIA MORENO","594","497","1091"
"",""," INES ARANGO","1617","1421","3038"
"",""," LA BELLEZA","2180","1953","4133"
"",""," NUEVO PARAISO","1538","1179","2717"
"",""," PUERTO FRANCISCO DE ORELLANA","23598","21565","45163"
"",""," SAN JOSE DE GUAYUSA","1032","919","1951"
"",""," SAN LUIS DE ARMENIA","1049","963","2012"
"",""," TARACOA","1403","1213","2616"
"",""," Total","38523","34272","72795"
"","Total","","72130","64266","136396"
"Santo Domingo","SANTO DOMINGO DE LOS TSACHILAS"," ALLURIQUIN","5023","4702","9725"
"",""," EL ESFUERZO","3020","2743","5763"
"",""," LUZ DE AMERICA","5690","5191","10881"
"",""," PUERTO LIMON","4892","4452","9344"
"",""," SAN JACINTO DEL BUA","6134","5584","11718"
"",""," SANTA MARIA DEL TOACHI","2991","2624","5615"
"",""," SANTO DOMINGO DE LOS COLORADOS","150428","155204","305632"
"",""," VALLE HERMOSO","4880","4455","9335"
"",""," Total","183058","184955","368013"
"","Total","","183058","184955","368013"
"Santa Elena","LIBERTAD                      "," LA LIBERTAD","48030","47912","95942"
"",""," Total","48030","47912","95942"
"","SALINAS                       "," ANCONCITO","6116","5706","11822"
"",""," JOSE LUIS TAMAYO","11054","11010","22064"
"",""," SALINAS","18266","16523","34789"
"",""," Total","35436","33239","68675"
"","SANTA ELENA                   "," ATAHUALPA","1689","1843","3532"
"",""," CHANDUY","8337","8026","16363"
"",""," COLONCHE","16158","15164","31322"
"",""," MANGLARALTO","15200","14312","29512"
"",""," SAN JOSE DE ANCON","3439","3438","6877"
"",""," SANTA ELENA","26816","26358","53174"
"",""," SIMON BOLIVAR","1757","1539","3296"
"",""," Total","73396","70680","144076"
"","Total","","156862","151831","308693"
"Zonas No Delimitadas","EL PIEDRERO                   "," EL PIEDRERO","3305","3019","6324"
"",""," Total","3305","3019","6324"
"","LAS GOLONDRINAS               "," LAS GOLONDRINAS","2768","2534","5302"
"",""," Total","2768","2534","5302"
"","MANGA DEL CURA                "," MANGA DEL CURA","11083","9675","20758"
"",""," Total","11083","9675","20758"
"","Total","","17156","15228","32384"
